---------------------TTTT----------------------------------------------------------------TTTTT------
---------------------TTTT----------------------------------------------------------------TTTTT------
---------------------TTTT--------------------------------------------------E-------------T-T-T------
----j----------------TTTT---TTTT-----------ooooooo----------------------------TTTTT------TTTTT------
-----jj--------------TTTT---TTTT----------------------------------------------TTTTT------TTTTT----oo
---j---jjMMM-----E---TTTT---TTTT-----E---SSSSSSSSS-E--------------------------TTTTT---------------EE
MMj-----XXXX---------TTTT---TTTT--------------------------------------------------------------------
XXX------------------TTTT---TTTT--------------------------------------------------------------------
----------------------------TTTTJM-------------------------------JM-----jMM-----------JM------------
--------------------------------XX-----S?SSSSSSSSS----------jM---XX----jXXX-----------XX-------j----
-----------------E--E-----------X-------J-EEE---E-----------XX---X----j--------jM-----X--------X----
-----------------E--------------X-------J-------------------XX---X---j---------?Q-----X--------X----
------------MMMMMMMMMMMMMMMMMMMJX-MMMMMMAMMMMMMMMMMMMMMMMMMjoXMMJX-Mj------MMMj--MMMMJX-MMMMMMjXMMMM
------------XXXXXXXXXXXXXXXXXXXXX-XXXXXXXXXXXXXXXXXXXXXXXXXXXXXXXX-XX------XXXX--XXXXXX-XXXXXXXXXXXX

使用的PROMPT: "no pipes, little enemies, some blocks, some coins,  many rect, low elevation"