TTTT------------------------------------------------------------------------------------------------
-TTT---------------------------------------------------------------------------------TTTTTT---------
-TTT-------------------------------------------------------TTTTT---------------------TTTT-T---------
-TTTj----------------------------------------TTTTT---------T-T-T---------------------TTTT-T---------
-----jj----------------------TTTTTTT---------T-------------T-TTT---------------------TTTTTT---------
---j---jjMMM-----------------TT-T------------T-T-T---------TTTTT-----------XX-----------------------
MMj-----XXXX-----------------T-TT--T---------T------------------------------------------------------
XXX--------------------------TTTTTTT---------T-T----------------------------------------------------
--------------------------------JM-----------T--T----------o-----JM-----jMM-----------JM------------
--------------------------------<>------?-Q--TTTTT----------jM---<>----jXXX-----------<>-------j----
--------------------------------[]------J-------------------<>---[]---jXX------jM-----[]-------X----
--------------------------------[]------J-------------------[]---[]--jXXX------<>-----[]------------
------------MMMMMMMMMMMMMMMMMMMJ[]MMMMMMAMMMMMMMMMMMMMMMMMMj[]MMJ[]MjXXXX--MMMj[]MMMMJ[]MMMMMMj-MMMM
-----------XXXXXXXXXXXXX<XXXXXXXXXXXXXXXXXXXXXXXXXXXXXXXXXXXXXXXXXXXXXXXX--XXXX[]XXXXXXXXXXXXXX-XXXX

使用的PROMPT: "some pipes, no enemies, little blocks, little coins,  no rect, high elevation"