------------------------------------------------------------------------------------------TTTTTTT---
-----------------------------------TTTTT----------------------------------T---------------TT-T-TT---
-------------------------TTTT------TT-TT---------------TTTT---------------T---------------T-T-T-T---
----j---------------TTTTTTTTT------T-T-T---------------TTTT---------------TTTT------------TT-T-TT---
-----jj-------------TT----TTT------TT-TT---------------TTTT---------------TTTT------------TTTTTTT---
---j---jjMMM--S-----TT-T-TTTT------TTTTT---------S-----TTTT---------------TTTT----------------------
MMj-----XXSS--------TTTTTTTTT----------------------------------------------TTT----------------------
XXX-----XX-----------------------------------------------------------------TTT----------------------
--------XX----------------------JM-------------------------------JM-----jMMTTT--------JM------------
--------XXSSSSS-----------------<>------?QQ------S----------jM---<>----jXXX-----------<>-------j----
--------------------------------[]------J-------------------<>---[]---jXXXX----jM-----[]-------<>---
--------------------------------[]------J-------------------[]---[]--jXXXXX----<>-----[]-------[]---
------------MMMMMMMMMMMMMMMMMMMJ[]MMMMMMAMMMMMMMMMMMMMMMMMMj[]MMJ[]MjXXXXXXMMMj[]MMMMJ[]MMMMMMj[MMMM
---------<>XXXXXXXXXXXXXXXXXXXXXXXXXXXXXXXXXXXXXXXXXXXXXXXXXXXXXXXXXXXXXXXXXXXXXXXXXXXXXXXXXXXXXXXXX

使用的PROMPT: "many pipes, little enemies, some blocks, no coins,  no rect, high elevation"