----------------TTTTTTTT---------------------------------------------------------------------------T
----------------TT----TT-------------------------------------------------------TTTTTTTTT-----------T
----------------T-TT---T--------------------------TTTTT------------------------TT---T-TT-----------T
----j-----------T--T---T-TTTT---------------------TT-TT------------------------T-T--T-TT-----------T
-----jj---------T----T-T---TT----------------------T-TT------------------------T--T-T--T-----------T
---j---jjMMM----T--TT--T-T--T----------------------T--T------------------------T-T-T-T-T-----------T
MMj-----XXXX----T--TT--T-TT-T---------------------T-T-T------------------------T----TTTT------------
XXX-------------T-T---TT--T-T---------------------T-T-T------------------------TTTTTTTTT------------
----------------TT--T--T-T-TT---JM-----------------T-TT----------JM-----jMM-----------JM------------
----------------TTTTTTTT-TTTT---XX------?Q--------TTTTT-----jM---XX----jXXX-----------XX-------j----
--------------------------------XX------J-------------------XX--------jXX------jM--------------X----
--------------------------------XX------J----------------------------jXXX------XX-------------------
------------MMMMMMMMMMMMMMMMMMMJXXMMMMMMAMMMMMMMMMMMMMMMMMMj--MMJ--MjXXX---MMMjXXMMMMJ--MMMMMMj-MMMM
-----------XXXXXXXXXXXXXXXXXXXXXXXXXXXXXXXXXXXXXXXXXXXXXXXXX--XXX--XXXX----XXXXXXXXXXX--XXXXXXX-XXXX

使用的PROMPT: "no pipes, no enemies, no blocks, little coins,  no rect, high elevation"