-----------------TTTTT------------------------------------------------------------------------------
-----------------TT-TT------------------------------------------------------------------------------
-----------------T-T-T-------------------------------------------------------TTTTTT--------TTTTTTT--
----j------------TTTTT-------------------------------------------------------TT-T-T--------T--T-TT--
-----jj----------TT--T-------------------------------------------------------T-T-TT--------T--T-TT--
---j---jjMMM-----TTTTT-------------------------------------------------------TT-T-T--------TTTTTTT--
MMj-----XXXX-----------------------------------------------------------------TTTTTT-----------------
TTT-------------------------------------------------------------------------------------------------
TTT-----------------------------JM---------E---------------------JM-----jMM-----------JM------------
TTT-------------------------E-E-XX-----E?SSSSSSSSS--XXXX----jM---XX----jXXX-----------<>--E----j----
--T-------------EE---------E----XX------J-------------------<>---XX---j--------jM-----[]-----E-X----
TTT-----------------------------XX------J-------------------[]---XX--j---------<>-----[]------------
T-T---------MMMMMMMMMMMMMMMMMMMJXXMMMMMMAMMMMMMMMMMMMMMMMMMj[]MMJXXMjB-----MMMj[]MMMMJ[]MMMMMMj-MMMM
-----------XXXXXXXXXXXXXXXXXXXXXXXXXXXXXXXXXXXXXXXXXXXXXXXXX[]XXXXXXXX-----XXXXXXXXXXXXXXXXXXXX-XXXX

使用的PROMPT: "little pipes, little enemies, no blocks, no coins,  some rect, low elevation"