--------------------------------------------------------------------------------------------------------------------------------------------------------------------------------------------------------
--------------------------------------------------------------------------------------------------------------------------------------------------------------------------------------------------------
--------------------------------------------------------------------------------------------------------------------------------------------------------------------------------------------------------
----j---------------------------------------------------------------------------------------------------------------------------------------------------------------------------------------------------
-----jj-------------------------------------------------------------------------------------------------------------------------------------------------------------------------------------------------
---j---jjMMM--------------------------------------------------------------------------------------------------------------------------------------------------------------------------------------------
MMj-----------------------------------------------------------------------------------------------------------------------------------------------------------------------------------------------------
--------------------------------------------------------------------------------------------------------------------------------------------------------------------------------------------------------
--------------------------------JM-------------------------------JM-----jMM-----------JM----------------------------------------------------------------------------------------------------------------
------------------------------------------------------------jM---------j-----------------------j--------------------jM------------------jjM-------------------------------------------------------------
----------------------------------------J-----------------------------j--------jM-------------------------------------------J---------------------------------------------------------------------------
----------------------------------------J----------------------------j------------------------------------------------------J---------------------------------------------------------------------------
------------MMMMMMMMMMMMMMMMMMMJ--MMMMMMAMMMMMMMMMMMMMMMMMMj--MMJ--Mj------MMMj--MMMMJ--MMMMMMj-MMMMMMMMMMMMMMMMMMMj--MMMMMMAMMMMMMMMMMj---MMMMMMMMMMMMMMMMMMMMMMMMMMMMMMMMMMMMMMMMMMMMMMMMMMMMMMMMMMMMM
--------------------------------------------------------------------------------------------------------------------------------------------------------------------------------------------------------