--------------------------------------------------------------------------------------------------------------------------------------------------------------------------------------------------------
--------------------------------------------------------------------------------------------------------------------------------------------------------------------------------------------------------
--------------------------------------------------------------------------------------------------------------------------------------------------------------------------------------------------------
----j---------------------------------------------------------------------------------------------------------------------------------------------------------------------------------------------------
----Pjj-------------------------------------------------------------------------------------------------------------------------------------------------------------------------------------------------
---jPPPjjMMM--------------------------------------------------------------------------------------------------------------------------------------------------------------------------------------------
MMjPPPPPPPPP--------------------------------------------------------------------------------------------------------------------------------------------------------------------------------------------
PPPPPPPPPPPP--------------------------------------------------------------------------------------------------------------------------------------------------------------------------------------------
PPPPPPPPPPPP--------------------JM-------------------------------JM-----jMM-----------JM----------------------------------------------------------------------------------------------------------------
PPPPPPPPPPPP--------------------PP--------------------------jM---PP----jPPP-----------PP-------j--------------------jM------------------jjM-------------------------------------------------------------
PPPPPPPPPPPP--------------------PP------J-------------------PP---PP---jPPPP----jM-----PP-------P--------------------PP------J-----------PPP-------------------------------------------------------------
PPPPPPPPPPPP--------------------PP------J-------------------PP---PP--jPPPPP----PP-----PP-------P--------------------PP------J-----------PPP-------------------------------------------------------------
PPPPPPPPPPPPMMMMMMMMMMMMMMMMMMMJPPMMMMMMAMMMMMMMMMMMMMMMMMMjPPMMJPPMjPPPPPPMMMjPPMMMMJPPMMMMMMjPMMMMMMMMMMMMMMMMMMMjPPMMMMMMAMMMMMMMMMMjPPPMMMMMMMMMMMMMMMMMMMMMMMMMMMMMMMMMMMMMMMMMMMMMMMMMMMMMMMMMMMMM
PPPPPPPPPPPPPPPPPPPPPPPPPPPPPPPPPPPPPPPPPPPPPPPPPPPPPPPPPPPPPPPPPPPPPPPPPPPPPPPPPPPPPPPPPPPPPPPPPPPPPPPPPPPPPPPPPPPPPPPPPPPPPPPPPPPPPPPPPPPPPPPPPPPPPPPPPPPPPPPPPPPPPPPPPPPPPPPPPPPPPPPPPPPPPPPPPPPPPPPP
