--------------------------------------------------
--------------------------------------------------
-----jj-------------------------------------------
MMMMj--j------jj----------------------------------
--------jMMMMj------------------------------------
----------------j---------------------------------
---------------------------------j----------------
--------------------------------j-j---------------
-----------------jMMMM--------Jj------------------
--------------------------------------------------
--------------------------------------------jjj--J
-------------------------------------------------J
----------------------MMMMMMMJ-----MMMMMMMMj---jMA
--------------------------------------------------
