----------------------------------------------------------------------------------------------------
----------------------------------------------------------------------------------------------------
----------------------------------------------------------------------------------------------------
----j-----------------------------------------------------------------------------------------------
-----jj---------------------------------oooooooooo-------------------------------------------------o
---j-SSjjMMM----ooo--------------------SSSSSSSSSSS-------------------------------------------------S
MMjX-----SSS----SSS---------------------------------------------------------------------------------
XX-X------------------------------------------------------------------------------------------------
XX-X-------------E--------------JM-------------------------------JM-----jMM-----------JM------------
X------------S--S?S?SSSS--------<>------?SSSSSSSSS----------jM---?S----jQ?Q-----------SQ-------j---S
--------------------------------[]------J--------------------]--------j--------jM-------------------
--------------------------------[]------J--------------------]-------j---------->-------------------
------------MMMMMMMMMMMMMMMMMMMJ[]MMMMMMAMMMMMMMMMMMMMMMMMMj-]MMJ--Mj------MMMj-]MMMMJ--MMMMMMj-MMMM
XXXXXXXX-XXXXXXXXXXXXXXXXXXXXXXXXXXXXXXXXXXXXXXXXXXXXXXXXXXX-XXXX--XX------XXXX-XXXXXXXXXXXXXXX-XXXX

使用的PROMPT: "many pipes, many enemies, no blocks, many coins,  some rect, low elevation"