----------------------------------------------------------------------------------------------------
-----------------T----------------------------------------------------------------------------------
-----------------TTTTTTT----------------------------------------------------------------------------
----j------------TT--T-T----------------------------------------------------------------------------
-----jj----------T-T---T----------------oooooooooo-------------------------------------------------o
S--j--SjjMMM-----T-T---T---------------SSSSSSSSSSS-------------------------------------------------S
MMj-----XXXX-----T-----T----------------------------------------------------------------------------
XXX-----XXXX-----TTT-TTT----------------------------------------------------------------------------
XXX-----XXXX-----TTTTT----------JM-------------------------------JM-----jMM-----------JM------------
X---------XX--------------------<>--------SSSSSSSS----------jM---<>----jQQQ-----------<>-------j---S
--------------------------------[]------J--------------------X---[]---j--------jM-----[]------------
--------------------------------[]------J------------------------[]--j---------->-----[]------------
------------MMMMMMMMMMMMMMMMMMMJ[]MMMMMMAMMMMMMMMMMMMMMMMMMj--MMJ[]Mj------MMMj-]MMMMJ[]MMMMMMj-MMMM
XXXXXXXXXXXXXXXXXXXXXXXXXXXXXXXXXXXXXXXXXXXXXXXXXXXXXXXXXXXX--XXXXXXX------XXXX-XXXXXXXXXXXXXXX-XXXX

使用的PROMPT: "some pipes, many enemies, many blocks, no coins,  no rect, low elevation"