----------------------------------------------------------------------------------------------------
----------------------------------------------------------------------------------------------------
-------------------TTTTTT---------------------------------------------------------------------------
----j--------------TTTT-T---------------------------------------------------------------------------
-----jj------------T----T---------------oooooooooo------------------------------------------------oo
---j-SSjjMMM-------T----T--------------SSSSSSSSSSS------------------------------------------------SS
MMjX---XXXXX-------T----T---------------------------------------------------------------------------
XX-X---XXXXX-------TTTTTT---------------------------------------------------------------------------
XX-X---XXXXX-------TTT----------JM-------------------------------JM-----jMM-----------JM------------
X------XXXXX--------------------<S------?-SSSSSSSS----------jM---SS----jXX?-----------<Q-------j--SS
X-------------------------------[-------J--------------------X--------jXXX-----jM-----[-------------
X-------------------------------[-------J----------------------------jXXXX------>-----[-------------
X-----------MMMMMMMMMMMMMMMMMMMJ[-MMMMMMAMMMMMMMMMMMMMMMMMMj--MMJ--MjXXXXX-MMMj-]MMMMJ[-MMMMMMj-MMMM
XXXXXXXXXXXXXXXXXXXXXXXXXXXXXXXXXXXXXXXXXXXXXXXXXXXXXXXXXXXX--XXXX-XXXXXXXXXXXX-XXXXXXXXXXXXXXX-XXXX

使用的PROMPT: "little pipes, some enemies, some blocks, no coins,  many rect, low elevation"