----------------------------------------------------------------------------------------------------
----------------------------------------------------------------------------------------------------
--------------TTTTT---------------------------------------------------------------------------------
----j---------TTTTT---------------------------------------------------------------------------------
-----jj----------TT----------------------ooooooooo-------------------------------------------------o
S--j-SSjjMMMo----TT--------------------SSSSSSSSSSS-------------------------------------------------S
MMjX-----SSST--TTTT---------------------------------------------------------------------------------
XX-X--------T-TTTTT---------------------------------------------------------------------------------
XX-X--------T-T-TT--------------JM-------------------------------JM-----jMM-----------JM------------
XX----------?-------------------<>--------SSSSSSSS----------jM---<>----jQQQ-----------<>-------j---S
--------------------------------[]------J-------------------->---[]---j--------jM-----[]------------
--------------------------------[]------J--------------------]---[]--j---------->-----[]------------
------------MMMMMMMMMMMMMMMMMMMJ[]MMMMMMAMMMMMMMMMMMMMMMMMMj-]MMJ[]MjX-----MMMj-]MMMMJ[]MMMMMMj-MMMM
XXXXXXXXXX-XXXXXXXXXXXXXXXXXXXXXXXXXXXXXXXXXXXXXXXXXXXXXXXXX-XXXXXXXXX-----XXXX-XXXXXXXXXXXXXXX-XXXX

使用的PROMPT: "little pipes, little enemies, some blocks, many coins,  no rect, high elevation"