----------------------------------------------------------------------------------------------------
----------------------------------------------------------------------------------------------------
----------------------------------------------------------------------------------------------------
----j-----------------------------------------------------------------------------------------------
-----jj---------------------------------oooooooooo------------------------------------------------oo
S--j--SjjMMMoooooooSoSooo--------------SSSSSSSSSSS------------------------------------------------SS
MMj------SSSSSSSSSS-S-SSS---------------------------------------------------------------------------
SX--------------------------------------------------------------------------------------------------
-X------------------------------JM-------------------------------JM-----jMM-----------JM------------
-------------SSSSSSSSSSSS-------<>--------SSSSSSSS----------jM---SS----jQQQ-----------<Q-------j--SS
--------------------------------[]------J--------------------Q--------j--------jM-----[-------------
--------------------------------[]------J----------------------------j----------S-----[-------------
------------MMMMMMMMMMMMMMMMMMMJ[]MMMMMMAMMMMMMMMMMMMMMMMMMj--MMJ--Mj------MMMj--MMMMJ[-MMMMMMj-MMMM
XXXX-XX-XX-XXXXXXXXXXXXXXXXXXXXXXXXXXXXXXXXXXXXXXXXXXXXXXXXX--XXX--XX------XXXX--XXXXXXXXXXXXXX-XXXX

使用的PROMPT: "some pipes, many enemies, little blocks, some coins,  many rect, low elevation"