----------------------------------------------------------------------------------------------------
----------------------------------------------------------------------------------------------------
-----------------TTTTTTTT---------------------------------------------------------------------------
----j------------TTT--TTT---------------------------------------------------------------------------
-----jj----------T--TT-TT---------------oooooooooo-------------------------------------------------o
---j-STjjMMM-----T--TT-TT--------------SSSSSSSSSSS-------------------------------------------------S
MMjX--TXXSXX-----TTT--TTT---------------------------------------------------------------------------
XX-X--T----X-----TTTTTTTT---------------------------------------------------------------------------
XX-X--T----X-----TTT-T----------JM-------------------------------JM-----jMM-----------JM------------
XX------------------------------<>---------SSSSSSS----------jM---<>----jQQQ-----------<Q-------j---S
--------------------------------[]------J--------------------X---[]---j--------jM-----[-------------
--------------------------------[]------J------------------------[]--j---------->-----[-------------
------------MMMMMMMMMMMMMMMMMMMJ[]MMMMMMAMMMMMMMMMMMMMMMMMMj--MMJ[]Mj------MMMj-]MMMMJ[-MMMMMMj-MMMM
XXXXXXXXXXXXXXXXXXXXXXXXXXXXXXXXXXXXXXXXXXXXXXXXXXXXXXXXXXXX--XXXXXXX------XXXX-XXXXXXXXXXXXXXX-XXXX

使用的PROMPT: "little pipes, no enemies, many blocks, little coins,  little rect, high elevation"