----------------------------------------------------------------------------------------------------
----------------------------------------------------------------------------------------------------
--------------------TTTTT---------------------------------------------------------------------------
----j---------------TTTTT---------------------------------------------------------------------------
-----jj-------------T-------------------oooooooooo------------------------------------------------oo
S--j---jjMMM--------T------------------SSSSSSSSSSS------------------------------------------------SS
MMj<---XXSXS--------T-TTT---------------------------------------------------------------------------
TXX[---XX-X---------TTTTT---------------------------------------------------------------------------
TXXX---XX-X---------TT-TT-------JM-------------------------------JM-----jMM-----------JM------------
-------XXSXSS-------------------<S--------SSSSSSSS----------jM---SS----jQQQ-----------<Q-------j--SS
T-------------------------------[-------J--------------------[--------j--------jM-----[-------------
--------------------------------[-------J--------------------[-------j---------->-----[-------------
------------MMMMMMMMMMMMMMMMMMMJ[-MMMMMMAMMMMMMMMMMMMMMMMMMj-[MMJ--Mj------MMMj-]MMMMJ[-MMMMMMj-MMMM
XXXXXXXXXXXXXXXXXXXXXXXXXXXXXXXXXXXXXXXXXXXXXXXXXXXXXXXXXXXX-XXXX--XX------XXXX-XXXXXXXXXXXXXXX-XXXX

使用的PROMPT: "no pipes, little enemies, little blocks, some coins,  little rect, high elevation"