----------------------------------------------------------------------------------------------------
--T-------------------------------------------------------------------------------------------------
--T----------------TTTTTT----------------------------TTTTTT-----------------------------------------
--T-j--------------TT--TT----------------------------TT---T-----------------------------------------
-----jj------------T-TT-T---------------oooooooooo---T-TTTT-----------------------------------------
S--j->-jjMMMo------T----T---------------SSSSSSSSSS---T----T-----------------------------------------
MMj<-]---SSS]------T-TT-T----------------------------TTTTTT-----------------------------------------
TT-[-]------]------T---TT----------------------------TT---------------------------------------------
TT-[-]------]------T-T-TT-------JM---------------------T---------JM-----jMM-----------JM------------
T--[-]------Q-------------------<>---------SSSSSSS----------jM---<>----jQQQ-----------<>-------j----
T--[-]--------------------------[]------J-------------------<>---[]---j--------jM-----[]-------<----
---[-]--------------------------[]------J-------------------[]---[]--j---------->-----[]-------[----
---[-]------MMMMMMMMMMMMMMMMMMMJ[]MMMMMMAMMMMMMMMMMMMMMMMMMj[]MMJ[]Mj------MMMj-]MMMMJ[]MMMMMMj[MMMM
XXXX-XX-----XXXXXXXXXXXXXXXXXXXXXXXXXXXXXXXXXXXXXXXXXXXXXXXXXXXXXXXXX------XXXX-XXXXXXXXXXXXXXXXXXXX

使用的PROMPT: "some pipes, little enemies, little blocks, little coins,  some rect, high elevation"