----------------------------------------------------------------------------------------------------
----------------------------------------------------------------------------------------------------
----------------------------------------------------------------------------------------------------
----j-----------------------------------------------------------------------------------------------
-----jj---------------------------------oooooooooo-------------------------------------------------o
---j-SSjjMMM------ooooo----------------SSSSSSSSSSS-------------------------------------------------S
MMjX-----SSS------SSSSS-----------------------------------------------------------------------------
XX-X------------------------------------------------------------------------------------------------
XX-X----------------------------JM-------------------------------JM-----jMM-----------JM------------
X-----------------SSSSSSS-------<>------?-SSSSSSSS----------jM---SQ----jQQQ-----------<Q-------j---S
--------------------------------[]------J--------------------Q--------j--------jM-----[-------------
--------------------------------[]------J----------------------------j---------->-----[-------------
------------MMMMMMMMMMMMMMMMMMMJ[]MMMMMMAMMMMMMMMMMMMMMMMMMj--MMJ--MjX-----MMMj-]MMMMJ[-MMMMMMj-MMMM
XXXXXXXXXXXXXXXXXXXXXXXXXXXXXXXXXXXXXXXXXXXXXXXXXXXXXXXXXXXX--XXXX-XXX-----XXXX-XXXXXXXXXXXXXXX-XXXX

使用的PROMPT: "no pipes, some enemies, little blocks, many coins,  many rect, low elevation"