----------------------------------------------------------------------------------------------------
----------------------------------------------------------------------------------------------------
------------------TTTT---------------------------------TTTT-----------------------------------------
----j-------------T-TTT--------------------------------T--------------------------------------------
-----jj-----------TT--------------------oooooooooo-----T-TT----------------------------------------o
S--j--SjjMMMo-----TT-------------------SSSSSSSSSSS-----T-T-----------------------------------------S
MMj------SSSS-----TTTT---------------------------------T--------------------------------------------
XX----------------TTTTTT--------------------------------TTT-----------------------------------------
XX----------------TTT-----------JM-------------------------------JM-----jMM-----------JM------------
X-------------------------------<>--------SSSSSSSS----------jM---<>----jQQQ-----------<>-------j---S
--------------------------------[]------J-------------------<>---[]---j--------jM-----[]------------
--------------------------------[]------J-------------------[]---[]--j---------->-----[]------------
------------MMMMMMMMMMMMMMMMMMMJ[]MMMMMMAMMMMMMMMMMMMMMMMMMj[]MMJ[]MjX-----MMMj-]MMMMJ[]MMMMMMj-MMMM
XXXXXXX-XX-XXXXXXXXXXXXXXXXXXXXXXXXXXXXXXXXXXXXXXXXXXXXXXXXXXXXXXXXXXX-----XXXX-XXXXXXXXXXXXXXX-XXXX

使用的PROMPT: "many pipes, many enemies, no blocks, little coins,  some rect, high elevation"