------------------------------------------------------------------------------------TTTTTT----------
-----------------------------------------------TTT----------TTTTT-------------------T-TTTT----------
-----------------------------------------------T-T----------TTTTT-------------------T---T----TTTT---
----j-------------------T----------------------T-T----------TT--T-------------------T--TTT---TTTT---
-----jj-----------------T----------------------T-T----------TTTTT-------------------TTT------TTTT---
---j---jjMMM------------T----------------------TT-----------TTTTT-------------------TTTTTT---TTTT---
MMj-----XXXX------------T----------------------TTT--------------------------------------------------
XXX-----------------------------------------------TTTT----------------------------------------------
--------------------------------JM----------------T-TT-----------JM-----jMM-----------JM------------
--------------------------------<>------?---------TTTT------jM---<>----jXXX-----------<>-------j----
--------------------------------[]------J---------TTTT------<>---[]---jXX------jM-----[]-------X----
--------------------------------[]------J-------------------[]---[]--jXXX------<>-----[]-------X----
------------MMMMMMMMMMMMMMMMMMMJ[]MMMMMMAMMMMMMMMMMMMMMMMMMj[]MMJ[]MjXXXX--MMMj[]MMMMJ[]MMMMMMjXMMMM
---------XXXXXXXXXXXXXXXXXXXXXXXXXXXXXXXXXXXXXXXXXXXXXXXXXXXXXXXXXXXXXXXX--XXXXXXXXXXXXXXXXXXXXXXXXX

使用的PROMPT: "little pipes, no enemies, some blocks, no coins,  no rect, low elevation"