-----------------------------------------------------------------------------------TTTTTTT----------
-----------------------------------------------------------------------------------TT---TT----------
---------------------------------------------------------------------------TT------T-TTTTT----------
----j-------------------------------------------TT--TTTTTT-----------------TT------T-T-TTT----------
-----jj----------------E------------------------TT--T-T-TT------------------T------TT-TT-T----------
---j---jjMMM------------------------------------TT--T-TTTT------------------T------TTTTTTT----------
MMj-----XXXX------------------------------------TT--TTTTTT-----------------TT-----------------------
XXX----------------TT-TT----------------------------------------------------------------------------
-------------------TTTTT--------JM-------------------------------JM-----jMM-----------JM------------
-------------------TTTTT--------<>------?-------------------jM---XX----jXXX-----------<>-------j----
-------------------T-TTT--------[]------J-------------------<>--------jXXXX----jM-----[]-------X----
--------------------------------[]------J-------------------[]-------jXXXXX----XX-----[]-------X----
------------MMMMMMMMMMMMMMMMMMMJ[]MMMMMMAMMMMMMMMMMMMMMMMMMj[]MMJ--MjXXX---MMMjX-MMMMJ[]MMMMMMjXMMMM
-----------XXXXXXXXXXXXXXXXXXXXXXXXXXXXXXXXXXXXXXXXXXXXXXXXXXXXXX--XXXXX---XXXXX-XXXXXXXXXXXXXXXXXXX

使用的PROMPT: "little pipes, no enemies, little blocks, no coins,  little rect, low elevation"