-----------------------------------------------------------TTTTT---------------------TTT------------
-----------------TTTT--------------------------------------TTTTT---------------------TTT-------TTTT-
-----------------TTTT----SSSSSSSSSSSSSSSSSSSSSSSSS---------TTTTT---------------------TTT-------TTTT-
----j------------TTTT----------[]--------------------------TTTTT---------------------TTT-------TTTT-
-----jj----------TTTT----------[]----------------------------------------------------TTT-------TTTT-
---j---jjMMM-----TTTT----------[]--------------E-E----SS--------------------------E------------TTTT-
MMj-----XXSS-----TTTT----------[]---------------------[]---------------------------------------TTTT-
TTT--------------TTTT----------<>---------------------[]-------------------------E-------------TTTT-
-TT-----------------------------JM--------------------[]---------JM-----jMM-----<>----JM------------
-TT----------------------E------<>-----??SSSS---------XXXS--jM---<>----jXXX-----[]S---<>-------j----
-----------E------E-------E----E[]------J-------------------<>---[]---jXXX-----jM-----[]-------B----
------------------E---B---------[]------J---------B---------[]---[]--jXXXX-----B------[]-------b----
---E--------MMMMMMMMMMMMMMMMMMMJ[]MMMMMMAMMMMMMMMMMMMMMMMMMj[]MMJ[]MjXXXXX-MMMjb-MMMMJ[]MMMMMMjBMMMM
XXXXXXXXXXXXXXXXXXXXXXXXXXXXXXXXXXXXXXXXXXXXXXXXXXXXXXXXXXXXXXXXXXXXXXXXXX-XXXXXEXXXXXXXXXXXXXXXXXXX

使用的PROMPT: "many pipes, many enemies, little blocks, no coins,  some rect, low elevation"