--------------------------------------------TTTTTT---------------------------------TTTTT------------
--------------------------------------------T-T------------------------------------T-TTTTTTTTT------
--------------------------------------------T--TT----------------------------------T---TTT-TTT------
----j---------------------------------------TT------TTTTT--------------------------T-T--T-T--T------
-----jj------------TTTTTT-------------------T-TTT---T---T--------------------------TT-TT-TT-TT------
---j---jjMMM-------TTTTTT-------------------T----T--T--TT------------------XXX-----TTTTTTTTTTT------
MMj-----XXXX-------TTTTTT-------------------TT-TT---TTTTT-------------------------------------------
XXX----------------TTTTTT-------------------TT--TT--------------------------------------------------
-------------------TTTTTT-------JM----------TTTTTT-----S---------JM-----jMM-----------JM------------
--------------------------------<>------?-------------------jM---<>----jXXX-----------<>-------j----
--------------------------------[]------J-------------------<>---[]---jXXX-----jM-----[]-------X----
--------------------------------[]------J-------------------[]---[]--jXXX------<>-----[]------------
------------MMMMMMMMMMMMMMMMMMMJ[]MMMMMMAMMMMMMMMMMMMMMMMMMj[]MMJ[]MjXXXX--MMMj[]MMMMJ[]MMMMMMj-MMMM
-----------XXXXXXXXXXXXXXXXXXXXXXXXXXXXXXXXXXXXXXXXXXXXXXXXXXXXXXXXXXXXXX--XXXX[]XXXXXXXXXXXXXX-XXXX

使用的PROMPT: "little pipes, no enemies, little blocks, no coins,  little rect, high elevation"