----------------------------------------------------------------------------------------------------
----------------------------------------------------------------------------------------------------
----------------------------------------TTTTTTTTT---------------------------------------------------
----j-----------------------------oo----TT----T-T-TT------------TTTT--------------------------TTTT--
-----jj------------oo---------------oo--TT-TT-T-T-TT------------TTTT------------ooo-----------TTTT--
---j---jjMMM----E-ooo-------------------TTTTTTTTT-TT------------TTTT------------XXX-----------TTTT--
MMj-----XXXX-------ooooooTTTT---------------------TT------------------------------------------TTTT--
XXX----------------ooooooTTTT---------------------TT------------------------------------------TTTT--
-------------------oooooo-------JM----------------TT-------------JM-----jMM-----------JM------TTTT--
T-------------------XXXXX-------<>------?SS-------TT--------jM---<>----jXXXS----------XX-------j----
T-------------------------------[]------J-------------------<>---[]---j--------jM--------------X-o--
T-------------------------------[]------J-------------------[]---[]--j---------<>--------------X----
T-----------MMMMMMMMMMMMMMMMMMMJ[]MMMMMMAMMMMMMMMMMMMMMMMMMj[]MMJ[]Mj------MMMj[]MMMMJ--MMMMMMjXMMMM
T-----------XXXXXXXXXXXXXXXXXXXXXXXXXXXXXXXXXXXXXXXXXXXXXXXXXXXXXXXXX------XXXXXXXXXXX--XXXXXXXXXXXX

使用的PROMPT: "little pipes, no enemies, some blocks, some coins,  some rect, high elevation"