--------------------------------------------------TTTTT---------------------------------------------
-----------------TTTT-----------------------------TTTTT---------------------------------------------
-----------------TTTT----------STTTTT-------------TTTTT---------------------------------------------
----j------------TTTT----------[TTT-T-------------TTTTT---------------------------------------------
-----jj----------TTTT-------o--[TTT-T----oooo-----------------------------------ooo-----------------
---j---jjMMM-----TTTT----SS----[TTT-T----------------------------------SSSS-E---X-------SSSS--SSSSS-
MMj-----XXSS-------------------[TTT-T-------------------------------------------[----------[]-------
XXX-----XXS--------------------[TTTTT-------------------------E-----------------[----------[]-------
Xoo-----XX---------------------[JM--------E-E--------------------JM-----jMM-----[E----JM---[]-------
Xoo-----XXS------------------X-[-S------?-XX----------------jM---XX----jSSS-----[o----<>---[]--j----
Xo------XX-------------------X-[------E-J----E-----E--------<>---XX---jS-------jM-----[]E--<>--X----
Xo------XX---------------------[--------J--------------E----[]---XX--jB--------<>-----[]------------
Xo------XX--MMMMMMMMMMMMMMMMMMMJ--MMMMMMAMMMMMMMMMMMMMMMMMMj[]MMJXXMjB[----MMMj[]MMMMJ[]MMMMMMj-MMMM
XXXXXXXXXX-XXXXXXXXXXXXXXXXXXXXXX-XXXXXXXXXXXXXXXXXXXXXXXXXXXXXXXXXXXXXXXXXXXXXXXXXXXXXXXXXXXXX-XXXX

使用的PROMPT: "little pipes, some enemies, many blocks, little coins,  some rect, low elevation"