-----------------------------------------------TTT--------------------------------------------------
------------------------------------TTTTTT-----TTTTTT-----------------------------------------------
-------------------------TTT--------TT--TT-----TTTTTT----------------------SSSS--------------------T
----j---------------------TT--------TTTTTT-----TTTTTT-----------------------[]---------------------T
-----jj------------------TTT--------T-T-TT-----TTTTTT-----------------------[]---------------------T
---j---jjMMM---------XX-------------T--TTT-----TTT--------------------------[]---------------------T
MMj-----XXXX------------------------TT---T----------------------------------[]---------------------T
XXX---------------------------------TTTTTT----------------------------------[]---------------------T
--------------------------------JM-------------------------------JM-----jMM-[]--------JM------------
--------------------------------<>------?-------------------jM---<>----jXSS-<>--------<>-------j----
----------o---------------------[]------J-------------------<>---[]---jXX------jM-----[]-------X----
--------------------------------[]------J-------------------[]---[]--jXXX------<>-----[]-------X----
<>----------MMMMMMMMMMMMMMMMMMMJ[]MMMMMMAMMMMMMMMMMMMMMMMMMj[]MMJ[]Mj-XXX--MMMj[]MMMMJ[]MMMMMMjXMMMM
[]--XXXXXXXXXXXXXXXXXXXXXXXXXXXXXXXXXXXXXXXXXXXXXXXXXXXXXXXXXXXXXXXXX--XXX-XXXX[]XXXXXXXXXXXXXXXXXXX

使用的PROMPT: "many pipes, little enemies, some blocks, little coins,  no rect, high elevation"