--------------------------------------------------TTTTTT--------------------------------------------
-----------TTTTT----------------------------------TTTTTT--------------------------------------------
-----------T---T---------------------------TTTTTTT-----T---------------------TTTTTTTT---------------
----j------T--TT---------------------------TT--T---TTT-T---------------------T-T-T--T---------------
-----jj----TTTTT---------------------------T-T---TTTTT-T---------------------T-T-TT-T---------------
---j---jjMMM-------------------------------T-TTT--TTTT-T---------------------TTTTTTTT---------------
MMj----XXXXX-------------------------------TT----TT----T--------------------------------------------
XXX----------------------------------------TTTTTTT--T-TT--------------------------------------------
--------------------------------JM----------------TTTTTT---------JM-----jMM-----------JM------------
--------------------------------XX------?---B---------------jM---XX----jXXX-----------XX-------j----
---------------------E------------------J---b---------------XX--------j--------jM-----XX-------X----
----------------------------------------J-------------------XX-------j---------XX-----XX-------X----
------------MMMMMMMMMMMMMMMMMMMJ--MMMMMMAMMMMMMMMMMMMMMMMMMjXXMMJ--Mj------MMMj--MMMMJXXMMMMMMjXMMMM
------------XXXXXXXXXXXXXXXXXXXX--XXXXXXXXXXXXXXXXXXXXXXXXXXXXXXX--XX------XXXX--XXXXXXXXXXXXXXXXXXX

使用的PROMPT: "no pipes, some enemies, no blocks, no coins,  no rect, low elevation"