----------------------------------------------------------------------------------------------------
--------------------------TTT-----------------------------------------------------------------------
--------------------------TTT----------------------------------------------TTTTTT-------------------
----j---------------------TTT----------------------------------------------TTTTTT-------------------
-----jj---------------ooo-TTT--------------------------------------------ooTTTTTT-------------------
---j---jjMMM--------SSSSS-------------E-SSS----------------------E---------TTTTTT------SSSS---------
MMj----<>SSS--------[]---------------<>------------------------SSSSSX---------------------[]-------E
XXX----[]-----------[]----------E--o-[]--------------------E--------X---------------------[]--------
--X----[]-----------[]----------JM---[]--------------------------JM-X---jMM-----------JM--[]--------
--X----[]------SSS--[]-------SSSSS---XX-?SS-----------------jM---<>-X--jSSS-----------XS--[]---j----
--X----[]----E------<>------------------J-------------E-----<>---[]---jB-------jM-----X---<>---X---E
--X----[]-------------------------------J-------------------[]---[]--jBb-------<>-----X--------X----
--X----[]---MMMMMMMMMMMMMMMMMMMJ--MMMMMMAMMMMMMMMMMMMMMMMMMj[]MMJ[]MjB[]---MMMj[]MMMMJX-MMMMMMjXMMMM
-XX--XXXX---XXXXXXXXXXXXXXXXXXXXXXXXXXXXXXXXXXXXXXXXXXXXXXXXXXXXXXXXXXXXXXXXXXXXXXXXXXX-XXXXXXXXXXXX

使用的PROMPT: "little pipes, many enemies, some blocks, many coins,  no rect, high elevation"