-T--------------------------------------------------------------------------------------------------
-TT----------------------------------TTTT----------TTTT---------------------------------------------
-TTT---------------------------------TTTT----------TTTT-------------------------------------TTTTT---
-TTTj--------------------------------TTTT----------TTTT-----------------------TTTTT---------TTTTT---
-----jj---------------------ooo------TTTT----------TTTT------------ooo--------TTTTT---------TT-TT---
---j---jjMMM----------------XXX------TTTT----------TTTT-------------oo--------TTTTT------TTTT--TT---
MMj-----XXXX--------------------------------------------------------E---------TTTTT------TTTT--TT---
TTTT--------------------------------------------------------------------------TTTTT------TTTTT-TT---
TTTT----------------------------JM-------------------------------JM-----jMM---TTTTT---JM-TTTTT-TT---
TTTT----------------------------XX------?-------------------jM---XX----jXXX---TTTTT---XX-TTTTTTj----
TTTT------------------------------------J-------------------XX--------j--------jM-----X--------X----
-TTT------------------------------------J----------------------------j---------XX-----X-------------
-TTT--------MMMMMMMMMMMMMMMMMMMJ--MMMMMMAMMMMMMMMMMMMMMMMMMj--MMJ--Mj------MMMj--MMMMJX-MMMMMMj-MMMM
TTTT--------XXXXXXXXXXXXXXXXXXXX--XXXXXXXXXXXXXXXXXXXXXXXXXX--XXX--XX------XXXX--XXXXXX-XXXXXXX-XXXX

使用的PROMPT: "no pipes, no enemies, some blocks, some coins,  some rect, low elevation"