----------------------------------------------------------------------------------------------------
----------------------------------------------------------------------------------------------------
-----------------------------------------------------TTTTT------------------------------------------
----j------------TTTTTT------------------------------TTT-T------------------------------------------
-----jj----------T-TTTT------------------------------TTT-T------------------------------------------
---j---jjMMM-----T---TT-------------TTTTTTT----------TTTTT------------------------------------------
MMj----TTTTT-----TTTTTT-------------TT--TTT---------------------------------------------------------
TTTT---TT-T-------------------------TTT-T-T---------------------------------------------------------
TTTT---TTT-T--------------------JM--TTTTTTT----------------------JM-----jMMT----------JM------------
T-------T-TT--------------------<>--TT----------------------jM---XX----jXXXT----------XX-------j----
TTTT----TT-T--------------------[]--TTTTJ-------------SS----XX--------j----T---jM--------------X----
TTTT----TTT---------------------[]------J----------------------------j---------XX--------------X----
T---T---T--TMMMMMMMMMMMMMMMMMMMJ[]MMMMMMAMMMMMMMMMMMMMMMMMMj--MMJ--Mj------MMMj--MMMMJ--MMMMMMjXMMMM
TTTTT----TT-XXXXXXXXXXXXXXXXXXXXXXXXXXXXXXXXXXXXXXXXXXXXXXXX--XXX--XX------XXXX--XXXXX--XXXXXXXXXXXX

使用的PROMPT: "no pipes, no enemies, no blocks, no coins,  little rect, high elevation"