-------------------------T--------------------------------------------------------------------------
-------------------------T-------------------TTTTTTTT-------------------------------------------TTTT
-------------------------T-------------------TTTTT-TT-------------------------TTTTT-------------TTT-
----j--------------------T-------------------TTTTTTTT-------------------------TT-TT-------------TTT-
-----jj------------------T-------------------TTTTTTTT-------------------------TT-TT-------------T-T-
---j---jjMMM-------E-----T-------------------TTTTT-TT--------E----------------TTTTT-------------TT--
MMj-----XXXX--------------------------------------TTT-------------------------------------------TT--
XXX----------------------------------------------------------------E----------------------------TTTT
--------------------------------JM-------------------------------JM-----jMM-----------JM------------
--------------------------------XX-----S?SSSS---------------jM---XX----jXXX-----------XX-------j----
--------------------------------XX------J-------------------XX--------jXXX-----jM-----XX-------X----
--------------------------------XX------J-------------------XX-------jXXXX-----XX-----XX-------X----
------------MMMMMMMMMMMMMMMMMMMJXXMMMMMMAMMMMMMMMMMMMMMMMMMjXXMMJ--MjXXXXX-MMMj--MMMMJXXMMMMMMjXMMMM
------------XXXXXXXXXXXXXXXXXXXXXXXXXXXXXXXXXXXXXXXXXXXXXXXXXXXXX--XXXXXXX-XXXX--XXXXXXXXXXXXXXXXXXX

使用的PROMPT: "no pipes, little enemies, no blocks, no coins,  many rect, low elevation"