----------------------------------------------------------------------------------------------------
--------------------------------------------TT------------------------------------------------------
--------------------------------------------TTT-----------------------------------------------------
----j---------------------------------TTTT--TTT----------------TTTT---------------------------------
-----jj-------------------------------TTTT--TTT----------------TTTT---------------------------------
---j---jjMMM--------------------------TTTT--TTT----------------TTTT---------------------------------
MMj----XXXXX---------E-oo-------------TTTT--TTT----------------TTTT---------------------------------
XXX----XXXXX--------------------------TTTT---------------------TTTT---------------------------------
--o----XXXX---------------------JM----TTTT-----------------oo--TTJM-----jMM-----------JM------------
--o----XXXX---------------------XX--------------------------jM---XX----jXXX-----------XX-------j----
--oo---XXXX?--------------------XX------J-------------------XX--------jXX------jM--------------X----
--SS---XXXX---------------------?-------J----------------------------jXXXoo----XX--------------X----
--SS---XXXXSMMMMMMMMMMMMMMMMMMMJ--MMMMMMAMMMMMMMMMMMMMMMMMMj--MMJ--MjXXXXooMMMjXXMMMMJ--MMMMMMjXMMMM
-------XXXXSXXXXXXXXXXXXXXXXXXXX-XXXXXXXXXXXXXXXXXXXXXXXXXXX--XXX--XXXXXXXXXXXXXXXXXXXXXXXXXXXXXXXXX

使用的PROMPT: "no pipes, no enemies, some blocks, many coins,  no rect, high elevation"