-------------------------------------------------------------------------------TTTTT----------------
-----------------TTTTTTT-------------------------------------------------------T-TTT----------------
-----------------TT----T------------------------TT------oo---------------------T-TTT---------------T
----j------------T-T-T-T--------------TTTTTT----T------------------------------TTTTT---------------T
-----jj----------T---T-T--------------TT--TT----T--------------------------------------------------T
---j---jjMMM-----T-T---T--o-----------T-T--T----TT----------------------------------S--------------T
MMj----<>XXX-----T--TT-T--------------T-TT-T-----------------------------------------------TTT------
XXX----[]--------TT--TTT--------------TTTTTT-----------------------------------------------TTT------
-------[]--------TTTTTTT--------JM-------------------------------JM-----jMM-----------JM---TTT------
-------[]X----------------------<>------?-------------------jM---<>----jXXX-----------<>---TTT-j----
-------[]-------------<>--------[]------J-------------------<>---[]---jXXXX----jM-----[]-------<----
-------[]-----------------------[]------J-------------------[]---[]--jXXXXX----<>-----[]-------[----
-------[]---MMMMMMMMMMMMMMMMMMMJ[]MMMMMMAMMMMMMMMMMMMMMMMMMj[]MMJ[]MjXXXXXXMMMj[]MMMMJ[]MMMMMMj[MMMM
------XXXXXXXXXXXXXXXXXXXXXXXXXXXXXXXXXXXXXXXXXXXXXXXXXXXXXXXXXXXXXXXXXXXXXXXXXXXXXXXXXXXXXXXXXXXXXX

使用的PROMPT: "many pipes, no enemies, little blocks, no coins,  some rect, high elevation"