-------------------------TTTTTT--------------------------------------------------TTT----------------
-------------------------T-T-TT---------------------------TTTTTTTTTTT------------TTTTT--------------
-------------------------TTT--T-------------TTTTTT--------TT-----TT-T------------T-T-T--------------
----j--------------------T--T-T-------------T-------------T-TT--TTTTT------TT----T--T---------------
-----jj------------------T--TTT-------------T-TTTT--------T-T---TTT-T------TT----TT-----------------
---j---jjMMM-----------TTTTT--T-------------T---T---------T-T-TTT--TT------TT----TTTTT--------------
MMj-----SSSS-----------TTTTTTTT-------------TTTTT-TTTT----TT-----T--T------TT-----------------------
XXX--------------------T--------------------TT--T-TTTT----TTTTTTTTTTT------TT-----------------------
-----------------------TT-------JM----------TTTTTTTTTT-----------JM-----jMM-----------JM------------
-----------------------TT-------XX------?-------------------jM---XX----jXXX-----------XX-------j----
----------------------------------------J-------------------XX--------j--------jM-----X--------X----
----------------------------------------J----------------------------j---------XX-----X-------------
------------MMMMMMMMMMMMMMMMMMMJ--MMMMMMAMMMMMMMMMMMMMMMMMMj--MMJ--Mj------MMMj--MMMMJX-MMMMMMj-MMMM
------------XXXXXXXXXXXXXXXXXXXX--XXXXXXXXXXXXXXXXXXXXXXXXXX--XXX--XX------XXXX--XXXXXX-XXXXXXX-XXXX

使用的PROMPT: "no pipes, no enemies, little blocks, no coins,  some rect, low elevation"