--------------------TTTTT----------------------------------------------------TTTTTTTT-----------TTTT
--------------------TT-TT-----TTTTTTT----------------------------------------TT--T--T-----------TT-T
--------------------TTTTT-----T-TTT-T----------------------------------------TT--T-TT-----------T-T-
----j---------------T-T-T-----T--TTTT-------------------TTTTT----------------TTTTTTTT-----------T--T
-----jj-------------TT-TT-----TT----T-------------------TTT-T-----------------------------------TTT-
---j---jjMMM--------TTTTT-----TTTTTTT--SSSS-------S-----TTT-T-----------------------------------TTTT
MMj-----XXXX--------------------------------------------TTTTT---------------------------------------
XXX-------------------------------------------------------------------------------------------------
--X-----------------------------JM-------------------------------JM-----jMM-----------JM------------
--X-----------------------------<>-----S?SS-----------------jM---<>----jXXS-----------<>-------j----
--X-----------------------------[]------J-------------------<>---[]---jXXX-----jM-----[]-------<>---
--X-----------------------------[]------J-------------------[]---[]--jXXXX-----<>-----[]-------[]---
--X------E--MMMMMMMMMMMMMMMMMMMJ[]MMMMMMAMMMMMMMMMMMMMMMMMMj[]MMJ[]MjXXXXX-MMMj[]MMMMJ[]MMMMMMj[MMMM
XXX-----<>XXXXXXXXXXXXXXXXXXXXXXXXXXXXXXXXXXXXXXXXXXXXXXXXXXXXXXXXXXXXXXXXXXXXXXXXXXXXXXXXXXXXXXXXXX

使用的PROMPT: "many pipes, little enemies, no blocks, no coins,  many rect, low elevation"