----------------TTTTT-------------------------------------------------------------------------------
----------------TTTTT-------------------------------------------------------------------------------
----------------TTTTT-------------------------------------------------------------------------------
----j-----------TTTTT-------------------------------------------------------------------------------
-----jj---------------------------------------------------------------------------------------------
---j---jjMMM-----------E----------?-----E-------E---E-------S?S---------SSS-------------SSSS--------
MMj-----BSSS----------<>---------------<>------->--<>-----------------------------------------------
XXX-----b-------------[]---------------[]------<]--[]-----------------------------------------------
--X-----S-------------[]--------JM-----[]------[]--XX------------JM-----jMM-----------JM------------
--X-------------------XXX-------<>----QQ?QQQQQQXQQ----------jM---<>----jXXS-----------XS-------j----
--X-----------------------------[]------J-------------------<>---[]---jXXX-----jM-----X--------X----
--X-----------------------------[]------J-------------------[]---[]--jXXXX-----<>-----X--------X----
--X-------E-MMMMMMMMMMMMMMMMMMMJ[]MMMMMMAMMMMMMMMMMMMMMMMMMj[]MMJ[]MjBXXXX-MMMj[]MMMMJX-MMMMMMjXMMMM
--XX--------XX<>XXXXXXXXXXXXXXXXXXXXXXXXXXXXXXXXXXXXXXXXXXXXXXXXXXXXXXXXXX-XXXXXXXXXXXXXXXXXXXXXXXXX

使用的PROMPT: "some pipes, some enemies, no blocks, no coins,  many rect, high elevation"