--------------TTTTT---------------------------------------------------------------------------------
--------------TTTTT---TTT---------------------------------------------------------------------------
--------------T--TT---TTT----------------------?----------------------------------------------------
----j---------T-TTT---TTT---------------------------------------------------------------------------
-----jj-------TTTTT---TTT------------------oo------------------------------oo-----------------------
---j---jjMMM---------------------------------------------------------------XX-----------------------
MMj-----XXXX--------------------XX---XXXXXXXXXXXXX-------ooo----------------------------------------
XXX------------------------------------------------------oooo---------------------------------------
--------------------------------JM----------------------XXXXX----JM-----jMM-----------JM------------
--------------------------------XX------?-------------------jM---XX----jXXX-----------XX-------j----
----------------------------------------J-------------------<>--------jXX------jM-----XX-------X----
----------------------------------------J-------------------[]-------jXXX------XX-----XX------------
------------MMMMMMMMMMMMMMMMMMMJ--MMMMMMAMMMMMMMMMMMMMMMMMMj[]MMJ--MjXXXX--MMMjXXMMMMJXXMMMMMMj-MMMM
-----------XXXXXXXXXXXXXXXXXXXXX--XXXXXXXXXXXXXXXXXXXXXXXXXXXXXXX--XXXXXX--XXXXXXXXXXXXXXXXXXXX-XXXX

使用的PROMPT: "no pipes, no enemies, no blocks, many coins,  little rect, high elevation"