--------------TTTT------T---------------------------------------------------------------------------
--------------TTTT------T----------------------------------------------------------------TTTTTT-----
--------------TTTT------T-------------------TTTTT-TTTTTT---------------------------------T--TTT-----
----j---------TTTT------T------------TTTT---TTTTT-T-T--T-------------------TTTT----------T-T--T-----
-----jj-----------------T------------TTTT---TTTTT-T--T-T---------------------TT----------TT--TT-----
---j---jjMMM------------T------------TTTT---TTTTT-T-T--T-------------------T--T----------TTTTTT-----
MMj-----XXXX-------------------------TTTT---TTTTT--TT--T-----------------E-TT-T---------------------
XXX----------------------------------TTTT---TTTTT-TTTTTT-------------------TTTT---------------------
-------X---------------------E--JM-------------------------------JM-----jMM-----------JM------------
-------XX--------XXXXXXXS----XX-XX------?Q------------------jM---<>----jXXX-----------<>-------j----
----------------------------------------J-----------E-------XX---[]---j--------jM--E--[]-------X----
----------------------------------------J-------------------XX---[]--j---------<>-----[]-------X----
------------MMMMMMMMMMMMMMMMMMMJ--MMMMMMAMMMMMMMMMMMMMMMMMMjXXMMJ[]Mj------MMMj[]MMMMJ[]MMMMMMjXMMMM
------------XXXXXXXXXXXXXXXXXXXX-XXXXXXXXXXXXXXXXXXXXXXXXXXXXXXXXXXXX------XXXXXXXXXXXXXXXXXXXXXXXXX

使用的PROMPT: "little pipes, little enemies, little blocks, no coins,  little rect, high elevation"