----------------------------------------------------------------------------------------------------
----------------------------------------------------------------------------------------------------
---------------------------------------------------------------------------SSSSSSSSSSSSSSSSSSSSSSSSS
----j--------------------------------------------------------------------------[]---------------SSSS
-----jj-----------------------E---E----------------------------------E---------[]---------------SSSS
---j---jjMMM-------E----E---SSSSSSSS--------TTTT------------------QQQQQ--------[]---------------SS--
MMj-----TTTT-----------<>-------------------TTTT--------oo---------------------<>-------------------
XXX-----T-T-T----------[]-------------------TTTT---X------------------------------------------------
--X-----T-TTT----------[]-------JM----------TTTT---X-------------JM-----jMM-----------JM------------
--X-----T-T-T------SSSS[]-----SSSS-----Q?----------XSSSSSS--jM---XX----jXXX-----------<>-------j----
--X-----T-T-T----------<>---------------J---E---------------<>---XX---j--------jM-----[]-------X----
--X-----TTTTT---------------------------J-------------------[]---XX--j---------<>-----[]-------X----
--X-----T---MMMMMMMMMMMMMMMMMMMJ--MMMMMMAMMMMMMMMMMMMMMMMMMj[]MMJXXMjB-----MMMj[]MMMMJ[]MMMMMMjXMMMM
--X---------XXXXXXXXXXXXXXXXXXXX-X<>XXXXXXXXXXXXXXXXXXXXXXXXXXXXXXXXXX-----XXXXXXXXXXXXXXXXXXXXXXXXX

使用的PROMPT: "little pipes, some enemies, no blocks, many coins,  no rect, high elevation"