----------------------------------------------------------------------------------------------------
---TTTTT-----------------TTTT-------TTTT------------------------------------------------------------
---TTT-T-----------------TTTT-------TTTT--------------------------------TTT-------------------------
---TjTTT-----------------TTTT-------TTTT--------------------------------TTT-------------------------
-----jjT------------E----TTTT-------TTTT--------------------------------TTT-------------------------
---j---jjMMM-------SSS-----------E--TTTT--------E--------SS-------------TTT-------------------------
MMj<E---BSSS------------<------------------->--<>---------------------------------------------------
XXX[]---b---------------[--------E---------<]--[]------EB-------------------------------------------
XXX[]------<>----------E[-------JM------E--[]--[]-----<>b--------JM-----jMM-----------JM----------E-
XXX[]------[]------SSSSS<-------<>------XQQQQQ-QQQ----[]X---jM---<>----jBSSS----------XX-------j----
XXX<>------[]-------------------[]------J------------B[]----<>---[]---jBb------jM-----XX---B---B----
XXX[]------<>---------E---------[]------J------------b<>E---[]---[]--jBbB------<>-----XX---b---bB--B
XXX[]------[MMMMMMMMMMMMMMMMMMMJ[]MMMMMMAMMMMMMMMMMMMMMMMMMj[]MMJ[]MjBbB[]-MMMj[]MMMMJXXMMMMMMjBMMMM
XXXXXXXXXXXXXXXXXXXXXXXXXXXXXXXXXXXXXXXXXXXXXXXXXXXXXXXXXXXXXXXXXXXXXXXXXXXXXXXXXXXXXXXXXXXXXXXXXXXX

使用的PROMPT: "many pipes, some enemies, many blocks, many coins,  no rect, low elevation"