--------------TTTT-------------------------------------------------------------------------TTTTTTT--
--------------TTTT-------------------------TTTTTTT-----------------------------------------T-TT-TT--
--------------TTTT-------------------------TTTT-T------------------------------------------T-TT-TT--
----j---------TTTT-------------------------T-TTTT-TTTTT------------------------------------T-TTTTT--
-----jj-------TTTT-------TTTTTTT-----------TT--TT-TTTTT---------------------------------------------
---j---jjMMM--TTTT-------TT-TT-T-----------TTTTTTTTT-TT--------------------?------------------------
MMj-----XXXX--------------TT--TT------------------T-TTT---------------------------------------------
XXX-----------------------T-TTTT-------------------T--T---------------------------------------------
--------------------------T---TTJM----------------TTTTT----------JM-----jMM-----------JM------------
-------------------------TTTTTTTTT------?-QQQQ--------------jM---<>----jXXX-----------<>-------j----
----------------------------------------J-------------------<>---[]---j>-------jM-----[]---SS--<>---
----------------------------------------J-------------------[]---[]--j<]-------<>-----[]-------[]---
------------MMMMMMMMMMMMMMMMMMMJ--MMMMMMAMMMMMMMMMMMMMMMMMMj[]MMJ[]Mj-[]---MMMj[]MMMMJ[]MMMMMMj[MMMM
----------XXXXXXXXXXXXXXXXXXXXXX--XXXXXXXXXXXXXXXXXXXXXXXXXXXXXXXXXXX-XXXXXXXXX[]XXXXXXXXXXXXXXXXXXX

使用的PROMPT: "some pipes, no enemies, some blocks, no coins,  little rect, high elevation"