TT--------------------------------------------------------------------------------------------------
TT------------------------------------------------------------------------------------------------TT
TT-ooo--------TTT---------------------------------------------------------------------------------T-
TT--j---------TTT---------------------TTTTT-------------------------------T---------o-------------T-
-T---jj-------TTT------------oo-------TTTTT-----------------------ooo---o-T-----oo-oo-------------T-
TT-j---jjMMM--TTT---------------------TTTTT----------------------SSSSSS---T-----XXXXXXX-----------T-
MMj-----XXXX--------------------------TTTTT-----oo----TTTT----------------T-----------------oooo--T-
XXX----------------------------------------------oooo-TTTT----------------------------------------T-
----------------------------XXX-JM--------------------TTTT-------JM-----jMM-----------JM----------TT
-----o-----------------------XX-XX--------------------TTTT--jM---<>----jXXXS----------<>-------j--TT
o-------------------------------X-------J-------------TTTT--<>---[]---jXXXX----jM-----[]-------X----
o-------------------------------X-------J-------------------[]---[]--jXXXXX----<>-----[]-------X----
----------o-MMMMMMMMMMMMMMMMMMMJX-MMMMMMAMMMMMMMMMMMMMMMMMMj[]MMJ[]MjXXXXXXMMMj[]MMMMJ[]MMMMMMjXMMMM
----------XXXXXXXXXXXXXXXXXXXXXXX-XXXXXXXXXXXXXXXXXXXXXXXXXXXXXXXXXXXXXXXXXXXXXXXXXXXXXXXXXXXXXXXXXX

使用的PROMPT: "some pipes, no enemies, many blocks, little coins,  many rect, low elevation"