---------------------------------------------------------------------------TTT-----------TTTTTT---TT
----------------TTTTTT----------------------------TTTTTTT-------------------TT-----------TT---T---TT
----------------TT---T--------------------------------TTT------------------TTT-----------TT-T-T---TT
----j-----------T-T-TT--------------------------TTT-T---T-------------------TT-----------T-T--T---T-
-----jj---------T--T-T--------------------------T--T-T--T------------------TTT-----------T-T--T---TT
---j---jjMMM----TT--TT------TTTTT---------------T--T-T--T-------------------TT-----------TT-TTT---TT
MMj-----TTTT----TTTTTT------TTTTT---------------T-T-T--TT------------------TTT-----------TTTTTT-----
TTT-----T--T----------------TT-TT---------------TTTTTTTTT-------------------------------------------
TTT-----TTT-----------------T-TTJM--------------TT---------------JM-----jMM-----------JM------------
TTT-----TT-T----------------TTTTTT------?Q------------------jM---<>----jXXX-----------<>-------j----
-TT-----TTTT----------------------------J-------------------<>---[]---j--------jM-----[]-------X----
TTT-------------------------------------J-------------------[]---[]--j---------<>-----[]-------X----
--T---------MMMMMMMMMMMMMMMMMMMJ--MMMMMMAMMMMMMMMMMMMMMMMMMj[]MMJ[]Mj------MMMj[]MMMMJ[]MMMMMMjXMMMM
------------XXXXXXXXXXXXXXXXXXXX--XXXXXXXXXXXXXXXXXXXXXXXXXXXXXXXXXXX------XXXXXXXXXXXXXXXXXXXXXXXXX

使用的PROMPT: "some pipes, no enemies, little blocks, no coins,  some rect, low elevation"