-------------------------------------------------------------------------TT-------------------------
-------------------------------------------------------------------------TT-------------------------
--------E----------------------------------------------------?-----------TT-------------------------
----j------E-------------------------------------T-----------------------TT-------------------------
-----jj----E--SS------ooo-------ooooo------------T-oo--------ooo---------TT-----------------E-------
---j---jjMMM----------E------E-XXXXXX------------TSSSS------XXXX---------TT------------?SSSSS-------
MMj-----XXXX--------------X----------------------TS---------XXX------------------------E------------
XXX-----------------------X------E---------------T--------------------------------------------------
------------E-E---------E-X-----JM---------------T---------------JM-----jMM-----------JM------------
------------SSSSSSSSSSSSS-X-----XX------?-------------------jM---XX----jXXX-----------XX----X--j----
-----------------------E--------XX------J-------------------XX---XX---j--------jM--------------X----
----------------------E---------XX------J-------------------XX-------j---------XX--------------X----
------------MMMMMMMMMMMMMMMMMMMJXXMMMMMMAMMMMMMMMMMMMMMMMMMjXXMMJ--Mj------MMMjXXMMMMJ--MMMMMMjXMMMM
------------XXXXXXXXXXXXXXXXXXXXXXXXXXXXXXXXXXXXXXXXXXXXXXXXXXXXX--XX------XXXXXXXXXXX-XXXXXXXXXXXXX

使用的PROMPT: "no pipes, some enemies, little blocks, many coins,  no rect, high elevation"