TT--------------------------------------------------------------------------TTTT--------------------
TT-------------------TTTT-------------TTT-----------------------------------TTTT--------------------
TT--------ooo--------TTTT-------------TTT-----------------------------------TTTT--------------------
TT--j----------------TTTT-------------TTT------------------E----------------TTTT--------oo----------
TT---jj-------Eoooo--TTTT-------------TTT----------E------------------------TTTT-------oooooo-------
---j---jjMMM--E------TTTT-----TTTT----TTT----------X------------------------TTTT------SSSSSSSS------
MMj-----XSSS---------TTTT-----TTTT----TTToooooo-----------------------------------------------------
XXX------------------TTTT-----TTTT-------------------------------ooooooooo--------------------------
-XX---------------------------TTJM-------------------------------JM-----jMM-----------JM------------
-XX---------------XXX---------TT-S------?-------------------jM---XS----jXXX-----------<>-------j----
oXX-------------------------------------J-------------------<>--------j--------jM-----[]-------X----
oXX-------------------------------------J-------------------[]-------jX--------<>-----[]-------X----
oXX-------EEMMMMMMMMMMMMMMMMMMMJ--MMMMMMAMMMMMMMMMMMMMMMMMMj[]MMJ--Mj-X----MMMj[]MMMMJ[]MMMMMMjXMMMM
XXXXXXXXXXXXXXXXXXXXXXXXXXXXXXXXXXXXXXXXXXXXXXXXXXXXXXXXXXXXXXXXX--XX-X----XXXX[]XXXXXXXXXXXXXXXXXXX

使用的PROMPT: "some pipes, little enemies, many blocks, some coins,  little rect, low elevation"