----------------------------------------------------------------------------------------------------
----------------------------------------------------------------------------------------------------
-------------SSSSSSSSSSSS-----------------------TTSSSSSSSSSSSS--------------------------------------
----j-------------------------------------------T-----------[]--------------------------------------
-----jj-----------------------------------------TT----------[]--------------------------------------
---j---jjMMM---------------XX------S---E----E---ET----------[]----------o---------------------------
MMj----<>SoS---------------[]---------<>---<>--<>---E-------[]-------oooo----------------ooooo---E--
XXX----[]oooooooooooooo-o--[]---------[]ooo[]--[]--<>-------[]-------------oooooooooo-----------<>oo
XXX----[]ooo--ooooooooooo--[]---JM----[]-oo[]--[]--[]-------[]---JM-----jMM-------XXXXJM--------[]-o
XXX----[]------SSSSSSSSSS--<>---<>----XX?--XS--XX--XX-------jM---<>----jXSS-------XXXXQQ-------j[]--
-------[]-----------------------[]------J-------------------<>---[]---jXX------jM--------------<----
-E-----[]---------------E-------[]------J-------------------[]---[]--jXXX------<>-------B------[----
<>-----[]-<>MMMMMMMMMMMMMMMMMMMJ[]MMMMMMAMMMMMMMMMMMMMMMMMMj[]MMJ[]MjBXXX--MMMj[]MMMMJ--MMMMMMj[MMMM
[]-----XX-[]XXXXXXXXXXXXXXXXXXXXXXXXXXXXXXXXXXXXXXXXXXXXXXXXXXXXXXXXXXXXX--XXXXXXXXXXXXXXXXXXXXXXXXX

使用的PROMPT: "many pipes, some enemies, some blocks, many coins,  some rect, high elevation"