----------------------------------------------------------------------------------------------------
---------------------------------------------------TTTTT--------------------------------------------
------------------------------TTTT-----------------TTT-T------------TTTT-----TTTT-------------------
----j-------------------------TTTT-----------------TT--T------------TTTT-----TTTT-------------------
-----jj-----------------------TTTT---------------T-T-TTT------------TTTT-----TTTT---------------Eooo
---j---jjMMM------------------TTTT------E---XX---TETT--T---------------------TTTT---------------XXXX
MMj-----<>XX-------------ooo---------------------T-TTT-T--------------------------------------------
TTT-----[]--------------------------------o------T-TTTTT--------------------------------------------
TTT-----[]----------------------JM-----E---------T---------------JM-----jMM-----------JM------------
-TT-----[]-----------------E----<>-----X?Q------------------jM---<>----jXXX-----------XX-------j----
TTT-----[]----------E------EE---[]------J----------E--------<>---[]---jXXXX----jM-----XX-------X----
TTT-----[]-----------------E-E--[]------J-------------------[]---[]--j<]XXX----<>-----XX-------X----
TTT-----[]--MMMMMMMMMMMMMMMMMMMJ[]MMMMMMAMMMMMMMMMMMMMMMMMMj[]MMJ[]Mj-[]XXXMMMj[]MMMMJXXMMMMMMjXMMMM
--------XX--XXXXXXXXXXXXXXXXXXXXXXXXXXXXXXXXXXXXXXXXXXXXXXXXXXXXXXXXX-XXXXXXXXX[]XXXXXXXXXXXXXXXXXXX

使用的PROMPT: "little pipes, some enemies, little blocks, little coins,  some rect, low elevation"