-----------------TTTTTTT----------------------------------------------------------------------------
-----------------TTTTTTT----------------------------------------------------------------------------
-----------------TTTTTTT----------------------------------------TTTTT-------------------------------
----j-----------E-----------------------------------------------TTTTT-------------------------------
-----jj--------<>-------------------oo--------------------------TTTTT------TTT----------------------
---j---jjMMM---[]---------XX----XXX------XXX----E--------S------TTTTT------TTT----SS--X----E--XXX---
MMj-----TTTT---[]---------[]----[]-------------<><----ooo-------TTTTT------TTT-----[]-[---<>--[][---
XXX-----TTTT---[]---------[]----[]-------------[][----<>ooooo--------------TTT-----[]-[---[]--[][---
XXX-----TTTT---[]---------[]----JM-------------[][----[]---------JM-----jMMTTT-----[]-JM--[]--[][---
XXX----ETTTT---<>------X--<>----<>------?-----XXXX----XXX---jM---?S----jBSS--------XX-XX--XX--Xj>---
XXX-----TTTT---------------E----[]------J-------------------<>--------j>b------jM--------------<>---
XXX-----------E-E---------------[]------J-------------------[]-------j<]X------<>-------------------
XXX---------MMMMMMMMMMMMMMMMMMMJ[]MMMMMMAMMMMMMMMMMMMMMMMMMj[]MMJ--Mj-[]X--MMMj[]MMMMJ--MMMMMMj-MMMM
XXX------XXXXXX<>XXXXXXXXX<>XXXXXXXXXXXXXXXXXXXXXXXXXXXXXXXXXXXXXX-XX-XXX--XXXXXXXXXXX-XXXXXXXX-XXXX

使用的PROMPT: "many pipes, many enemies, some blocks, little coins,  little rect, high elevation"