----------------------------------------------------------------------------------------------------
----------------------------TTTTTT------------------------------------------------------------------
--------------TTTTT-----T---T-TT-T----------------------------TTTTT---------------------------------
----j---------TTTTT-----T---T-TT-T----------------------------TTTTT-------------TTTT----------------
-----jj-------TTTTT-----T---TTTTTT----------E-----TT----------TTTTT-------------TTTT----------------
XSSj---jjMMM--TTTTT-----T-----------------SSS--E--TT----------TTTTT-------------TTTT-------E--------
MMj-----XSSS------------T---------------------<>--TT-----E----------------------TTTT------<>--------
XXX-----X---------------T---------------------[]--TT----<>-------------------E------------[]--------
XXX-----X---------------T------EJM------------[]--TT----[]-------JM-----jMM-----------JM--XX--------
XXX-----XSS---------------------<>------?SSSS-<>--TT----XXE-jM---<>----jBSS-----------<>-------j----
--------X-----------------------[]------J-------------------<>---[]---jXb------jM-----[]E------B----
--------X---------B-------------[]----B-J------E------------[]---[]--jBXX------<>-----[]--B----b--B-
--------X--EMMMMMMMMMMMMMMMMMMMJ[]MMMMMMAMMMMMMMMMMMMMMMMMMj[]MMJ[]MjBbXX--MMMj[]MMMMJ[]MMMMMMjBMMMM
------XXXXXXXXXXXXXXXXXXXXXXXXXXXXXXXXXXXXXXXXXXXXXXXXXXXXXXXXXXXXXXXXXXX-XXXXXXXXXXXXXXXXXXXXXXXXXX

使用的PROMPT: "many pipes, some enemies, many blocks, no coins,  some rect, low elevation"