TTTT----------TTTTTT----------------------------------------------------------------TTTTT-------TTTT
TTTT----------TT-T-T------------------------------TT--------------------------------TTTTT-------TT--
TTTT----------TT--TT------------------------------TT--------------------------------TTTTT-------T-T-
-TTTj---------T--T--------------------------------TT--------------------------------TTTTT-------T--T
-----jj-------T-T--T------------------------------TT--------ooo---------------------------------T-T-
---j---jjMMM--T--T--------------------------------TT--------XXX---------------------------------T--T
MMj-----XXXX--TTTTTT------------------------------TT----------------------------------------o---TTTT
XXX----------------------o--o------------o--------TT--TT--------------------------------------------
-XX----------------------]------JM--------------------TT---------JM-----jMM-----------JM------------
--X----------------------]------<>------?---X---------TT----jM---XX----jXXX-----------<>-------j----
-------------------------]------[]------J-------------TT----<>--------j--------jM-----[]-------<----
-------------------------]------[]------J-------------------[]-------j---------<>-----[]-------[----
------------MMMMMMMMMMMMMMMMMMMJ[]MMMMMMAMMMMMMMMMMMMMMMMMMj[]MMJ--Mj------MMMj[]MMMMJ[]MMMMMMj[MMMM
-----------XXXXXXXXXXXXXXXXXXXXXXXXXXXXXXXXXXXXXXXXXXXXXXXXX[]XXX--XX------XXXX[]XXXXXXXXXXXXXXXXXXX

使用的PROMPT: "some pipes, no enemies, some blocks, little coins,  little rect, high elevation"