---------------------------------------------------TTTT---------------------------------------------
-------------------------TTTT----------------------TTTT---------------------------------------------
-----------------E-------T-TT----------------------TTTT---------------------------------------------
----j------SSSSSSSSSSSSSS--TT----------------------TTTT-------------o-------------------------------
-----jj----------------SSTTTT-----Eoooo---------TT-TTTT-------ooo-----------------------oo----------
---j---jjMMM-E-----------TTTT-----XXXXX---------T--TTTT------------------o--------------oo----ooo---
MMj-----XXXX------------------------------------T--------------------------------------Eoo----------
XXX-----X---------------------------------------T--------------------------------------ooo----------
XXX-----oo----------------------JM--------------TT---------------JM-----jMM-----------JM------------
--------oo----------------------XX------?---------------E---jM---XX----jXXX-----------XX-------j----
--------oo------------------------------J---------------XXX-XX--------jXX------jM-----X--------X----
--------oo------------------------------J-------------------XX-------jXXXo-----XX-------------------
--------ooo-MMMMMMMMMMMMMMMMMMMJ--MMMMMMAMMMMMMMMMMMMMMMMMMjooMMJ--MjXXXXo-MMMjooMMMMJ--MMMMMMj-MMMM
--------XXX-XXXXXXXXXXXXXXXXXXXX--XXXXXXXXXXXXXXXXXXXXXXXXXXXXXXX--XXXXXXX-XXXXXXXXXXX--XXXXXXX-XXXX

使用的PROMPT: "no pipes, little enemies, some blocks, little coins,  many rect, low elevation"