----------------------------------------------------------------------------------------------------
-------------------------------------------------------------------------------------------------TTT
-------------------------------------------------------------------------------------------------TT-
----j--------------------TTTTTT------------------------------------------------------------------T-T
-----jj------------------TT-T-T------------------------------------------------------------------T-T
---j---jjMMM--------------TT-TT------------------------------------------------------------------T--
MMj-----XXXX----------------T-T--------------------------------------------TTTT------------------TTT
TTTTT--------------------T-TTTT-----------------------------------------------T------------------TTT
TTTT-T-T------------------TTT-T-JM-------------------------------JM-----jMMT-TT-------JM------------
TTTTTT-T-----------------TTTTTT-TT------?Q------------------jM---XX----jXXXTTTT-------XX-------j----
-TTTTT-T--------SSSSSS---TTTTTT-TT------J-------------------XX--------jXXXXTTTTjM--------------X----
-------T--------------------------------J----------------------------jXXXX-----XX--------------X----
------------MMMMMMMMMMMMMMMMMMMJ--MMMMMMAMMMMMMMMMMMMMMMMMMj--MMJ--MjXXXX--MMMjX-MMMMJ--MMMMMMjXMMMM
XX-----XXXXXXXXXXXXXXXXXXXXXXXXX--XXXXXXXXXXXXXXXXXXXXXXXXXX--XXX--XXXXXX--XXXXX-XXXXX--XXXXXXXXXXXX

使用的PROMPT: "no pipes, no enemies, no blocks, no coins,  little rect, low elevation"