---------------------------------TTTTTTTTTT-------T-------------------------------------------------
---------------------------------T-T---TT-T-------T------------------------------TTTT---------------
---------------------------------T--TT----T-------T-----TTTTTT-------------------TTTT---------------
----j----------------------------T--TT--T-T-------T-----TTT-TT-------------------TTTT---------------
--E--jj--------------------------TTTT--T-TT-------T-----TT-TTT------------E------TTTT------------TTT
---j---jjMMM----EE---------------TTTTTTTTTT-------T-----TT-TTT----------E-E----------------------TTT
MMj-----XXXX--------------------------------------------TT---T------------E----------------------TTT
XXX-----------------------------------------------------TTTTTT-----------------------------------TTT
--------------E-----------------JM----E--------------------------JM-----jMM-----------JM---------TTT
------------E-------------------XX----E-?-------E---------E-jM---XX----jXXX-----------XX-------j----
------------E-------------------XX---E--J-----------------E-XX--------j--------jM-----XX-------X----
--------------------------------XX------J----------------------------j---------XX-----XX------------
------------MMMMMMMMMMMMMMMMMMMJXXMMMMMMAMMMMMMMMMMMMMMMMMMj--MMJ--Mj------MMMjXXMMMMJXXMMMMMMj-MMMM
------------XXXXXXXXXXXXXXXXXXXXXXXXXXXXXXXXXXXXXXXXXXXXXXXX--XXX--XX------XXXXXXXXXXXXXXXXXXXX-XXXX

使用的PROMPT: "no pipes, little enemies, some blocks, no coins,  little rect, low elevation"