----------------------------------------------------------------------------------------------------
----------------------------------------------------------------------------------------------------
----------------------------------------------------------------------------------------------------
----j----------------------------------------------------------------------------------------------T
-E---jj-----------------------------E--------------------------------------------------------------T
-E-j---jjMMM----X----E------------SSSSS---------------------------XX---SSSS-----------QQQQQQ-------T
MMj-----XXXX--------<>-------------------------E---------------------------------------------------T
XXX-----------------[]------------------------<>-----E---------------------------------E-----------T
--------------------[]----------JM------------[]-----------------JM-----jMM-----------JM------------
------------------SS[]----XXS---XX----ES?S---SXX------------jM---XX----jXSS-----------<>-------j----
--------------------<>-------E--XX------J--E-------------E--<>---XX---j-X------jM-----[]---E---B----
----------------E-E-------------XX------J-------------------[]---XX--j---------B------[]-------b----
------------MMMMMMMMMMMMMMMMMMMJXXMMMMMMAMMMMMMMMMMMMMMMMMMj[]MMJXXMjB-----MMMjb-MMMMJ[]MMMMMMjBMMMM
-----------XXXXXXXXXXXXXXXXXXXXXXXXXXXXXXXXXXXXXXXXXXXXXXXXXXXXXXXXXXX----XXXXXX-XXXXXXXXXXXXXXXXXXX

使用的PROMPT: "some pipes, many enemies, no blocks, some coins,  little rect, low elevation"