-----------------------------------------------------------TTTT-----------------------TTTT----------
-----------------------------------------------------------TTTT-----------------------TTTT----------
------------------TTTT-------------------------------------TTTT-------------TTTTTT----TTTT--T-------
XX--j-------E-----TTTT-------------------------TTT---------TTTT-------------T-TTTT----TTTT--T-------
-----jj-----------TTTT-------------------------T-T---------TTTT-------------T-TT-T----TTTT--T----E-E
SS-j---jjMMM------TTTT-------------------------T-T-------------------E------TTTT-T----TTTT--T---SS-S
MMj-----XXXX-----------------------------------TTT------------------o-------TTTTTT----------T-------
XXX--------------------E----------------------------------------------------------------------------
--X-----------------------------JM-------------------------------JM-----jMM-----------JM------------
--X-----------------SSSSSE------XX------?QQQ-----B--E-E-----jM---<>----jXXX-----------<>-------j----
-->----------------E----->------XX------J--------b--E-------<>---[]---j--------jM-----[]-------X----
-<>------------E---------]------XX------J--------B----------[]---[]--j---------<>-----[]-------X----
-[]-------EEMMMMMMMMMMMMMMMMMMMJXXMMMMMMAMMMMMMMMMMMMMMMMMMj[]MMJ[]Mj------MMMj[]MMMMJ[]MMMMMMjXMMMM
-XXXXXXXXXXXXXXXXXXXXXXXXXXXXXXXXXXXXXXXXXXXXXXXXXXXXXXXXXXXXXXXXXXXX------XXXXXXXXXXXXXXXXXXXXXXXXX

使用的PROMPT: "little pipes, many enemies, little blocks, some coins,  no rect, high elevation"