----------------------------------------------------------------------------------------------------
--------------------------------------------------------------------------------TTTT----------------
--------------------------------------------------------------------------------TTTT----------------
----j---------------------------------------------------------------------------TTTT----------------
-----jj-------------------------------------------------------------------------TTTT-------TTTTT----
---j---jjMMM-----------------------------------------TTTTTTTTTT-----------------TTTT-------TT-TT----
MMj-----XXXX---------TTTT----------------------------T-T--T---T----------------------------TTTTT----
TTT------------------TT-T----------------------------T-T--T-T-T----------------------------T---T----
TTT------------------TT---------JM------------TTTT---TTTTTTTTTT--JM-----jMM-----------JM---TT-TT----
TTT------------------TTT--------XX------?Q----TT------------jM---XX----jXXX-----------XX---TTTTj----
TTT------------------TTTT-------X-------J-----TTTT----------XX--------j--------jM--------------X----
TTT-----------------------------X-------J-------------------X--------j---------XX-------------------
TTT---------MMMMMMMMMMMMMMMMMMMJX-MMMMMMAMMMMMMMMMMMMMMMMMMjX-MMJ--Mj------MMMjXXMMMMJ--MMMMMMj-MMMM
------------XXXXXXXXXXXXXXXXXXXXX-XXXXXXXXXXXXXXXXXXXXXXXXXXX-XXX--XX------XXXXXXXXXXX--XXXXXXX-XXXX

使用的PROMPT: "no pipes, no enemies, little blocks, no coins,  some rect, low elevation"