----------------------------------------------------------------------------------------------------
--------------------------------------TTTT----------------------------------------------------------
--------------------------------------TTTT----------------------------------------------------------
----j---------------------------------TTTT----------------------------------------------------------
-----jj-------------------------------TTTT-------------------------------------------------------E--
---j---jjMMM----E-------S-------------------------X------------E-----------SS-----------------XXS---
MMjB----BSSS---<>-B------------------------------<]--------------------------------------------[]--<
XXXX----b-S----[]-b---------------E--------B-----[]--------------------------------------------[]--[
XXXX----X----EE[]-X-E----X------JM------?-Bb-----Q]---E-B--------JM-----jMM--E--------JM-------[]--X
XXXX----XSSSSSSSXSXSS--XXXS-----XS------?-QQQQQ---XXSSS-X---jM---XS----jBSSXS-----S---XX-------jX--Q
XXXX----X------------E----------X-------J-------E-----------<>---X----jXb--X---jM-----XX-------B]---
X-XX----X----E----E-------------X-------J--B--B-------------[]---X---jBXX-EX---BS-----XX--BB---b----
X-XX----X-EEMMMMMMMMMMMMMMMMMMMJX-MMMMMMAMMMMMMMMMMMMMMMMMMj[]MMJX-MjBbXX--MMMjbSMMMMJXXMMMMMMjBMMMM
X-XX----XXXXXXXXXXXXXXXXXXXXXXXXXXXXXXXXXXXXXXXXXXXXXXXXXXXXXXXXXXXXXXXXXXXXXXXXXXXXXXXXXXXXXXXXXXXX

使用的PROMPT: "little pipes, many enemies, many blocks, no coins,  many rect, high elevation"