-----------------------------------------------------------------------------------------------TTTTT
-----------------------------------------------------------------------------------------------TT-T-
--------------------------------------------------TTTT-----------------------------------------TTT--
----j----------------------------------------------T-T-----------------------------------------T--T-
-----jj-------------------------------------------T-TT-----------------------------------------T--T-
---j---jjMMM--------------------------XXXXX--TTTTTT--T-----------------------------------------TT-T-
MMj-----XXXX---------------------------------TTT-T-TTT-----------------------------------------TTT--
XXX------------------------------------------TTTTT---T-----------------------------------------TTTTT
--------------------------------JM-----------TTTTTTTTT-----------JM-----jMM-----------JM------------
--------------------------------XX------?Q------------------jM---XX----jXXX-----------XX-------j----
----------------------------------------J-------------------XX---XX---jXXXX----jM--------------X----
----------------------------------------J-------------------XX---X---jXXXXX----XX--------------X----
------------MMMMMMMMMMMMMMMMMMMJ--MMMMMMAMMMMMMMMMMMMMMMMMMjXXMMJX-MjXXXXXXMMMjXXMMMMJ--MMMMMMjXMMMM
------------XXXXXXXXXXXXXXXXXXXX--XXXXXXXXXXXXXXXXXXXXXXXXXXXXXXXX-XXXXXXXXXXXXXXXXXXX--XXXXXXXXXXXX

使用的PROMPT: "no pipes, no enemies, no blocks, no coins,  no rect, low elevation"