TTT-------------------------------------------------------------------------------TTTTTTTT----------
-TT-------------------------------------------------------------------------------T--T-TTT----------
TTT----------------------TTTTTTTT------------TTTTT--------------------------------TT-T-TTT----------
-TT-j--------------------TTT--TTT------------TT-----------------------------------TT-T---T----------
TTT--jj----XXXXXXXXXXXXXX-TTT-T-T------------T--TT--------------------------------TTTT-TTT----------
---j---jjMMM-------------T-TTT--T------------TT-TT--------------------------------TTTTTTTT----------
MMj-----XXXX--------------T---TTT------------TTT-T-----XX-XXXXXXXXX---------------------------------
XXX----------------------TTTTTTTT------------TTTTT--------------------------------------------------
--------------------------------JM-----------TTTTT---------------JM-----jMM-----------JM------------
--------------------------------XX------?-------------------jM---XX----jXXX-----------XX-------j----
----------------------------------------J-------------------XX--------jXXX-----jM--------------X----
----------------------------------------J----------------------------jXXXX-----XX-------------------
------------MMMMMMMMMMMMMMMMMMMJ--MMMMMMAMMMMMMMMMMMMMMMMMMj--MMJ--MjXXXXX-MMMjX-MMMMJ--MMMMMMj-MMMM
------------XXXXXXXXXXXXXXXXXXXX--XXXXXXXXXXXXXXXXXXXXXXXXXX--XXX--XXXXXXX-XXXXX-XXXXX-XXXXXXXX-XXXX

使用的PROMPT: "no pipes, no enemies, little blocks, little coins,  no rect, high elevation"