-------------------------------------------------------------------TTT------------------------------
-------------------------TTTT--------------------------------------TTT--------TTTT---------TTTTT----
--------------------------TTT---------------------TTT--------------TTT-----o--TTTT---------TTTTT----
----j--------------E-----TTTT---------------------TTT--------------TTT--------TTTT---------TTTTT----
-----jj------------------TTTT------oooo-----------TTT--------------TTT--------TTTT---------TTTTT----
S--j---jjMMM-----XXXX----TTTT-----SSSSSSSSSSSSSSSSTTT--------------TTT--------TTTT---------TTTTT----
MMj-----XXXX-------------TTTT---------------------------------------------E---TTTT------------------
XXX------------------------------E----------------------------------------E-------------------------
--X-----------------------------JM-------------------------------JM-----jMM-----------JM------------
E-X----------------E-----S------XX------?SSSSSSSSS----------jM---XX----jXXX-----------XX-------j----
T------------------E-----E--E---X------EJ-----E----E--------XX--------j--------jM-----XX-------X----
T------------------E-----E------X-------J-------------------XX-------j---------XX-----XX-------X----
T----------EMMMMMMMMMMMMMMMMMMMJX-MMMMMMAMMMMMMMMMMMMMMMMMMjXXMMJ--Mj------MMMj--MMMMJXXMMMMMMjXMMMM
-----------XXXXXXXXXXXXXXXXXXXXXX-XXXXXXXXXXXXXXXXXXXXXXXXXXXXXXX--XX------XXXX--XXXXXXXXXXXXXXXXXXX

使用的PROMPT: "no pipes, some enemies, some blocks, many coins,  little rect, low elevation"