--------------------------------------------------------------------------T-TTTT--------------------
--------------------------------------------------------------------------T-TTTT--------------------
--------------------------------------------------------------------------T-TTTT--------------------
----j---------------------------------------------------------------------T-TTTT--------TTT---------
-----jj----------oo----------Eooo-oooo---------------ooooooo--------------T-------------TTT-----E---
---j---jjMMM----------------EE--------S------E----------------------------T-------SSS---TTT-----SSS-
MMj-----X>SS------SSSoSoo--<>---------------<>-----------------------------X----------E----------[]-
XXX-----[]--------Eoooooo--[]---------------[]---------------------------------------------------[]-
XXX-----[]--------ooooooo--XX---JM----------[]-------------------JM-----jMM---X-------JM---------[]-
XXX-----b]------------------XSSSSS------?---XX---S----------jM---<>----jXXX-----------XX-------j-[]-
--X--------E---E--E-E-------------------J------E-----E------<>---[]---jXXXX----jM-----XX-------B-<>-
----------------------------------------J-------------------[]---[]--jXXXXX----<>-----XX-------b----
-------EE-EEMMMMMMMMMMMMMMMMMMMJ--MMMMMMAMMMMMMMMMMMMMMMMMMj[]MMJ[]Mj-XXXXXMMMj[]MMMMJXXMMMMMMjBMMMM
-------X--XXXXXXXXXXXXXXXXXXXXXXXXXXXXXXXXXXXXXXXXXXXXXXXXXXXXXXXXXXX-XXXXXXXXXXXXXXXXXXXXXXXXXXXXXX

使用的PROMPT: "little pipes, many enemies, many blocks, some coins,  some rect, high elevation"