TT-------------------------------------------------------------------------TT-----------------------
TT-----------------------------------------------------------------------TTTT-----------------------
TT-----------------------------------------------------------------------TT-T-----------------------
TT--j------------------TT-------TTTT-------------------------------------TT-T-----------------------
TT---jj----------------TT-------TT-T-------------------------------------TTTT-----------------------
---j---jjMMM-----------TT-------TTTT------------------------------oo-----TTTT--------------XXX------
MMj-----XXXX-----------TT---TTTTT-TT--------------TTTTTT-----------oo-------T-----------------------
XXX------------TTTT----TT---TTTTT-----------------TTTT-T------------o------TT-----------------------
---------------TTTT----TT---T--TJM----------------TTT--T---------JM-----jMM-T---------JM------------
---------------TTTT---------TTTTTT-T----?QQ-------TTTTTT----jM---XX----jXXXTT---------XX-------j----
---------------TTTT---------TTTTTTTT----J---------TTTTTT----XX--------j--------jM--------------X----
----------------------------------------J----------------------------j---------XX-------------------
------------MMMMMMMMMMMMMMMMMMMJ--MMMMMMAMMMMMMMMMMMMMMMMMMj--MMJ--Mj------MMMj--MMMMJ--MMMMMMj-MMMM
------------XXXXXXXXXXXXXXXXXXXX--XXXXXXXXXXXXXXXXXXXXXXXXXX--XXX--XX------XXXX--XXXXX--XXXXXXX-XXXX

使用的PROMPT: "no pipes, no enemies, little blocks, little coins,  some rect, high elevation"