--------------------------------------------------------------------------------------------TTTTTT--
--------------------------------------------------------------------------------------------TT--TT--
--------------------------------------------------------------------------------------------TT-TTT--
----j---------------------------------------------------------------------------------------T-TTTT--
-----jj------------------------------------------------------oooo--------------ooooo--------TTTT-T--
---j---jjMMM------E--E--------SS------------E--------------SSSSSS-------------SSSSSSSSSSS---TT-T-T--
MMj-----TTTT-------------------------------<>-----------------------------------------------TTTTTT--
XXX-----TTTT-----------o--B---ooo----------[]----------------------------B--------------------------
X-X-----TTTT------------E-b-----JM---------[]------------E-------JM-----jMM----EE-----JM------------
X-X-----TTTT----------SSS-B-----<>-----??-SXXS-----------E--jM---<>----jXXX---SSS-----<>-------j----
X-X----------------------XX--E--[]------J------------E------<>---[]---jXXXX----jM-----[]-------B----
X-X-------------B---------------[]------J-------------------[]---[]--jXXXXX----B------[]-------b----
X-X---------MMMMMMMMMMMMMMMMMMMJ[]MMMMMMAMMMMMMMMMMMMMMMMMMj[]MMJ[]MjXXXXXXMMMjb-MMMMJ[]MMMMMMjBMMMM
XXXXXXXXXXXXXXXXXXXXXXXXXXXXXXXXXXXXXXXXXXXXXXXXXXXXXXXXXXXXXXXXXXXXXXXXXXXXXXXX-XXXXXXXXXXXXXXXXXXX

使用的PROMPT: "little pipes, many enemies, no blocks, many coins,  little rect, high elevation"