----------------------------------------------------------------------------------------------------
-------------------------SSSSSSTTTTTTTT---------------------------------------TTTTTT----------------
-------------------------S----[>TTTT--T---------------------TTTT--------------TTTT-T----------------
----j--------------------S----[]T----TT---------------------TTTT--------------TTT--T----------------
-----jj------------------S----[]T-TTT-T---------------------TTTT--------------TTTTTT----ooo---------
---j---jjMMM-----SSSSSSSSS----[]TT---TT-------------SSSSS---TTTT-------SSSS---TTTTTT----------------
MMj----?SSSS------[]--[]------[]TTTTTTT------------------------------------------------------------S
SSS---------------[]--[]------[]--------------------------------------------------------------------
S-S---------------[]--[]---E--[]JM-------------------------------JM-----jMM-----------JM------------
S-----------------[]--<>SSSS--[]XX------?--SSS------SSS-----jM---<>----jSSS-----------<>-------j----
------------------<>----------<]X-------J-------------------<>---[]---jX-------jM-----[]-------B----
----------------------EE--------X-------J-------------------[]---[]--jXX-------<>-----[]-------b----
oo----------MMMMMMMMMMMMMMMMMMMJX-MMMMMMAMMMMMMMMMMMMMMMMMMj[]MMJ[]MjXXXEooMMMj[]MMMMJ[]MMMMMMjBMMMM
XXXX-XXX----XXXXXXXXXXXXXXXXXXXXX-XXXXXXXXXXXXXXXXXXXXXXXXXXXXXXXXXXXXXXXXXXXXXXXXXXXXXXXXXXXXXXXXXX

使用的PROMPT: "little pipes, some enemies, no blocks, some coins,  many rect, high elevation"