----------------------------------------------------------------------------------------------------
----------------------------------------------------------------------------------------------------
----------------------------------------------------------------------------------------------------
----j-----------------------------------------------------------------------------------------------
-----jj-----------------------oo---------ooooooooo--Eoooo-----------------E-TTTT--------------------
---j---jjMMM-------E---------SSS---SSSS------------SSSSSS-----------------S-TTTT----------E-------SS
MMj-----XXXS------------------E---------------------------------------------TTTT-------------E------
XXX-----XXX-----------------------------oo-E-------o------------------------TTTT----------EE---E----
--X-----XXo---------------------JM-----------------oooo----------JM-----jMM-TTTT------JM----XX------
--X-----XX----------------------SS----E-?SSSS---XXSSSSSSS---jM---XX----jXXX-----------XX-------j----
--------XX--------------E------E--------J----------EEE------XX---XX---jXXX-----jM-----XX-------B----
--------XX--------------E------E--------J-------------------XX---XX--jXXXX-----B------XX---E---b----
--------XX--MMMMMMMMMMMMMMMMMMMJ--MMMMMMAMMMMMMMMMMMMMMMMMMjXXMMJXXMjBXXXX-MMMjb-MMMMJXXMMMMMMjBMMMM
--------XX-XXXXXXXXXXXXXXXXXXXXXXXXXXXXXXXXXXXXXXXXXXXXXXXXXXXXXXXXXXXXXXXXXXXXX-XXXXXXXXXXXXXXXXXXX

使用的PROMPT: "no pipes, many enemies, many blocks, little coins,  little rect, high elevation"