-----------------------------------------------------TTTTT------------------TTTT--------------------
-----------------------------------------------------TT-TT------------------TTTT--------------------
-----------------------------------------------------TT--T------------------TTTT--------------------
----j----------------------TTTT-------------------T--T--TT---------------------------------o--------
-----jj------o--ooooooooo--TTTT-------------oooo-oT--T---T------------------------------oooo--ooo---
---j---jjMMM----QQQQQQQQQ--TTTT------------ooooX-XT--T-T-T---------------o----------------XX--------
MMj-----SSSS-------------XX--------------oooo-----T--TT-TT------------------------------------------
XXX--------------------------------------oooo-----T--TTTTT-----TTTTTTT-----XXX----------------------
--------------------------------JM-------oooo------------------TTJM-TT--jMM-----------JM------------
------------SSSSSSSSSSSSS-------XX------?QQQQ---------------jM-TTTTTTT-jXXX-----------<>-------j----
----------------------------------------J-------------------XX--------j--------jM-----[]-------X----
----------------------------------------J-------------------XX-------j---------XX-----[]------------
-------o----MMMMMMMMMMMMMMMMMMMJ--MMMMMMAMMMMMMMMMMMMMMMMMMjXXMMJ--Mj------MMMj-XMMMMJ[]MMMMMMj-MMMM
-------XXXX-XXXXXXXXXXXXXXXXXXXX--XXXXXXXXXXXXXXXXXXXXXXXXXXXXXXXXXXX------XXXX-XXXXXXXXXXXXXXX-XXXX

使用的PROMPT: "little pipes, no enemies, little blocks, many coins,  little rect, low elevation"