---------------TTTTTT-------------------------------------------------------------------------------
---------------TTTTTT--------------------------------------TTTTTTTT---------------------------------
---------------T-T-TT--------------------------------------TTT----T---------------------------------
----j-ooo------TTT-TT--------------------------------------TT-T--TT---------------------------------
-----jj-o------TTTTTT-----oooo--------------------o--------TT---T-T------oo------ooooo-o-o---o------
---j---jjMMM--------------------------------------XX-------TT-TT--T-----XXX------------------o------
MMj-----XXXX------------o----------oooo---oooo-------------TTTTTTTT-------------------------ooo-----
XXX-----------------------------------------oooo-------------------------oo-------------------oo----
XXX----------------------oo-----JM----------oooooo---------------JM-----jMM-----------JM------------
-------------------------SS-----<>------?---SSSSSS----------jM---XX----jXXX-----------<>-------j----
--------------------------------[]------J-------------------<>------o-jXX------jM-----[]-------X----
--------------------------------[]------J-------------------[]-------jXXXoo----<>-----[]-------X----
o-----------MMMMMMMMMMMMMMMMMMMJ[]MMMMMMAMMMMMMMMMMMMMMMMMMj[]MMJ--MjXXXXooMMMj[]MMMMJ[]MMMMMMjXMMMM
X-----------XXXXXXXXXXXXXXXXXXXXXXXXXXXXXXXXXXXXXXXXXXXXXXXXXXXXX--XXXXXXXXXXXX[]XXXXXXXXXXXXXXXXXXX

使用的PROMPT: "little pipes, no enemies, little blocks, some coins,  many rect, high elevation"