----------------------------------------------------------------------------------------------------
----------------------------------------------------------------------------------------------------
--------------------------------------------------------------------------------------TTTTTT--------
----j--------------------------------------------X------------------------------------TTT-TT--------
-----jj-------------------------------------------------------------------------------T--TTT--------
---j---jjMMM---------------------------------------------------ooo--------------------T-TT-T--------
MMj----XXXXX----TTTTTT-----------------------------------------XXXX-------------------TTTTTT--------
TTTT------------TT--TT------------------------------------------------------------------------------
TTT-------------TT-TTT----------JM-------------------------------JM-----jMM-----------JM------------
TTT-T-----------TT--TT----------XX------?-------------------jM---XX----jXXX-----------XX-------j----
TTTTT-----------TTTTTT------------------J-------------------XX--------jS-------jM--------------X----
----------------------------------------J----------------------------jSS-------XX-------------------
------------MMMMMMMMMMMMMMMMMMMJ--MMMMMMAMMMMMMMMMMMMMMMMMMj--MMJ--Mj-SS---MMMj--MMMMJ--MMMMMMj-MMMM
---------XXXXXXXXXXXXXXXXXXXXXXX--XXXXXXXXXXXXXXXXXXXXXXXXXX--XXX--XX------XXXX--XXXXX--XXXXXXX-XXXX

使用的PROMPT: "no pipes, no enemies, no blocks, little coins,  little rect, low elevation"