----------------------------------------------------------------------------------------------------
-------------------------TTT----------------------TTT-----------------------------------------------
-------------------------TTT---TTTTT-------TTTT---TTT----------------------SSSSSSSSSSSSSSSSSSSSSSSSS
----j--------------TTTT--TTT---TTT-T-------TTTT---TTT----------------------------------[]---[]------
-----jj------------TTTT--TTT---TTTTT-------TTTT----TT----------------------------------[]---[]------
---j---jjMMM-------TTTT---TT---TTTTT-------TTTT---TTT----------------------------------[]---[]------
MMj----<>XXX-------TTTT--TTT---TTTTT---------------TT----------------------SSSSSSS-----[]---<>------
XXX----[]----------TTTT--------------------<>-----TTT---------------------------SSS----<>-----------
XXX----[]-----------------------JM---------[]--------------------JM-----jMM-----SSS---JM--------SS--
XXX----[]-----------------------<>------?QQQQQQQQ-----------jM---<>----jXXX-----SSS---<>-------j----
-------[]-----------------------[]------J----------------E--<>---[]---j-X------jM-----[]-------<>---
-------[]-----------------------[]------J-------------------[]---[]--j--X------<>-----[]-------[]---
-------[]---MMMMMMMMMMMMMMMMMMMJ[]MMMMMMAMMMMMMMMMMMMMMMMMMj[]MMJ[]Mj---X--MMMj[]MMMMJ[]MMMMMMj[MMMM
-------[]XXXXXXXXX<>XXXXXXXXXXXXXXXXXXXXXXXXXXXXXXXXXXXXXXXXXXXXXXXXX---X--XXXXXXXXXXXXXXXXXXXXXXXXX

使用的PROMPT: "many pipes, little enemies, little blocks, no coins,  some rect, high elevation"