---------------------------------------------------------------------------TT-----------------------
--------------------------------------------------TT---------------------TTTT------------TTTTTTT----
--------------------------------------------------TT---------------------TTTT------------TTTT-TT----
----j---------------------------------------------TT---------------------T-TT------------T---T-T----
-----jj-----------------E-------------------------TT---------------------TTTT-------oooooTTT--TT----
---j---jjMMM--X---------E-------------SSSSS--E-----T---------S-----------TT--------------TTTTTTT----
MMj-----<>SS--X--------<>--?----------------<>----TT------------------------------------------------
XXX-----[]----X--------[]-B-E---------------[]--------------------------------------E---X-----------
XXX-----[]----X--------[]-b-----JM----------[]----B--------------JM-----jMM-----------JM----------<>
XXX-----[]----XS-------XX-XXXXX-<>------?S--XX----XX--------jM---<>----jBSS-----------<>-------j--[]
XXX-----[]----X---------------XX[]------J------------E------<>---[]-E-j<>------jM-----[]-------<>-[]
XXX-----[]-----------------B--XX[]------J-------------B-----[]---[]--jB[]------<>-----[]-------[]-[]
XXX-----[]--MMMMMMMMMMMMMMMMMMMJ[]MMMMMMAMMMMMMMMMMMMMMMMMMj[]MMJ[]MjBb[]--MMMj[]MMMMJ[]MMMMMMj[MMMM
XXXXX---XX--XXXXXXXXXXXXXXXXXXXXXXXXXXXXXXXXXXXXXXXXXXXXXXXXXXXXXXXXXXXXXXXXXXXXXXXXXXXXXXXXXXXXXXXX

使用的PROMPT: "many pipes, many enemies, little blocks, many coins,  no rect, high elevation"