-----------TTT-------------------------------------------------TTTTTT--------------------TTTTTTTTT--
-----------TTTT--------------TTTTTTTTTT------------------------TT-TTT--------------------T-T-T--TT--
-----------T-TT--------------TT-TTT-TTT------------------------T-TT-T--------------------TT-TTT--T--
----j------TTTT--------------T-TTTT---T------------------------T--TTT--------------------T---TTT-T--
-----jj----------------------T-TT-T-T-T------------------------TTTTTT--------------------TTT----TT--
---j---jjMMM-----------------TT-TTT--TTT-----------------------TTTTTT--------------------TTTTTTTTT--
MMj-----XXXX-----------------TTTTTTTT-TT------------------------------------------------------------
XXX----------------------------------T-T------------------------------------------------------------
--------------------------------JMTT--TT-------------------------JM-----jMM-----------JM------------
--------------------------------TTTTTTTT--------------------jM---<>----jXXX-----------<>-------j----
----------------------------------------J-------------------<>---[]---j--------jM-----[]-------X----
----------------------------------------J-------------------[]---[]--j---------XX-----[]-------X----
------------MMMMMMMMMMMMMMMMMMMJ--MMMMMMAMMMMMMMMMMMMMMMMMMj[]MMJ[]Mj------MMMjXXMMMMJ[]MMMMMMjXMMMM
------------XXXXXXXXXXXXXXXXXXXX--XXXXXXXXXXXXXXXXXXXXXXXXXXXXXXXXXXX------XXXXX-XXXXXXXXXXXXXXXXXXX

使用的PROMPT: "little pipes, no enemies, no blocks, no coins,  no rect, low elevation"