------TT-----------------------------------------------TTTTT----------------------------------------
------TT----------------------------<>-----------------TTTTT---------------TTTTT--------------------
---S--TT----S-----------------------[]-----------------TT-TT----------------TTTT----SSSS--SSSSSSSSSS
----j-TT---E-----------------------X[]-----------------TTTTT----------------TTTT------[]------------
-----jj----------------------E-----[]]-----------------TTTTT----------------TTTT------[]------------
---j---jjMMM-----E----------SS-----X--->---E------XE----------------------------------[]------------
MMjS----XSSS----<>---E----------------<]--<>------[]-------------------------o--------<>------------
SSS-----X-------[]--<>o---------------[]--[]------[]------------------------------------------------
S-------X-------X---[]o--------EJM----[]oo[]------<>-------------JM-----jMM-----------JM------------
-S------X------XX---XS-------BS-SS----XX--XXS-----[]--------jM---<>----jXSS-----------<>-------j----
E-------X--------------------b----------J-----E---<>--------<>---[]---j-X------jM-----[]-------<----
-------<]-------E--------B---B----------J-------------------[]--B[]--jX-X------<>-----[]-------[----
-------[]---MMMMMMMMMMMMMMMMMMMJE-MMMMMMAMMMMMMMMMMMMMMMMMMj[]MMJ[]MjB]-X--MMMj[]MMMMJ[]MMMMMMj[MMMM
----XXXXX---XXXXXXXXXXXXXXXXXXXXXXXXXXXXXXXXXXXXXXXXXXXXXXXXXXXXXXXXXXXXXXXXXXXXXXXXXXXXXXXXXXXXXXXX

使用的PROMPT: "many pipes, many enemies, some blocks, many coins,  many rect, low elevation"