------------TTT---------------------------------TT--------------------------------------------------
---TTTT-----TTT-------------------TTTT----------TT------------TTTTT---------------------------------
---TTTT-----TTT-------------------TTTT----------T-------------TTTTT---------------------------------
---TjTT------TT-------------------TTTT----------T-------------TTTTT---------------------------E-----
---T-jj--------------E------------TTTT----------TT------------TTTTT--------------------------<>-----
---j---jjMMM----SSSSSSS--S--------TTTT----------TTS---------------------------SSSS----SSSS---[]-----
MMj-----XXSS----SS----[----------------------------------------------------------------------<>-----
XXX-----X-------------[]----------------------------------------------------------------------------
-------------------E--[]--------JM--------E----------------------JM-----jMM----E------JME-----------
-----------E-------EE-[]-SSS----<>-----S?SS---B---S---------jM---<>----jXXX---SSS-----<>-------j----
-----------E--E-ESSSS-<>--------[]------J-----b-------------<>---[]---jXXXX----jM-----[]-------B----
------------E-------------------[]------J-------------------[]---[]--jXXXXX----<>-----[]-------b----
<>----E----<MMMMMMMMMMMMMMMMMMMJ[]MMMMMMAMMMMMMMMMMMMMMMMMMj[]MMJ[]Mj-XXXXXMMMj[]MMMMJ[]MMMMMMjBMMMM
[]XXXXXXXX-[]XXXXXXXXXXXXXXXXXXXXXXXXXXXXXXXXXXXXXXXXXXXXXXXXXXXXXXXX-XXXXXXXXXXXXXXXXXXXXXXXXXXXXXX

使用的PROMPT: "many pipes, many enemies, little blocks, no coins,  some rect, low elevation"