----------------------------------------------------------------------------------------------------
----------------------------------------------------------------------------------------------------
----------------------------------------------------------------------------------------------TTTTT-
----j--------------------TTTTTTT--------------------------------------------------------------T-T-T-
-----jj------------------TTTT-TT--------------------------------------------------------o-----T-TTT-
---j---jjMMM---------XXX-T-T--TT-----------TTTTT------------------------XXX-------------------TTTTT-
MMj-----XXXX-----------------T-T-----TTTT--T-TTT----------------------------------------------------
XXX----------------------TTTTTTT-----T-TT--TTT-T----------------------------------------------------
--------------------------------JM---TTTT--TTT-T-----------------JM-----jMM-----------JM------------
--------------------------------<>---TTTT--TTTTT------------jM---XX----jXXX------SSS--<>-------j----
--------------------------------[]------J-------------------XX--------jXXX-----jM-----[]-------X----
--------------------------------[]------J----------------------------jXXXX-----XX-----[]-------X----
------------MMMMMMMMMMMMMMMMMMMJ[]MMMMMMAMMMMMMMMMMMMMMMMMMj--MMJ--Mj------MMMj--MMMMJ[]MMMMMMjXMMMM
-----------XXXXXXXXXXXXXXXXXXXXXXXXXXXXXXXXXXXXXXXXXXXXXXXXX--XXX--XX------XXXX--XXXXXXXXXXXXXXXXXXX

使用的PROMPT: "little pipes, no enemies, no blocks, little coins,  some rect, low elevation"