----------------------------------------------------------------------------------------------------
-------------------TTTTTT-----------------------------------------------------TTTT------------------
-------------------TT------------------------------TTTTT----------------------TTTT------------------
----j--------------T---T---------------------------TT--T-------E--------------TTTT------------------
-----jj------------TT---T--------------------------T-TTT----------------------TTTT------------------
---j---jjMMM----E--TTTTTT----------------SSSS------TT--T----------------------TTTT---------------E--
MMj-----XXXX---------------------------------------TTTTT------------E---------TTTT------------------
XXX--------------------------------------ooo-----------------------------------------------------ooo
--------------------------------JM-------------------------------JM-----jMM--E--------JM------------
----------o----------------E----XX-----E?-SSSS--------------jM---XX----jXXX-----------XX-------j----
----------XXX-----------------E-XX------J-------------E-----XX--------jXXXX----jM-----X--------X----
--------------------------------XX------J-------------------XX-------jXXXXX----XX-----X--------X----
-----------EMMMMMMMMMMMMMMMMMMMJXXMMMMMMAMMMMMMMMMMMMMMMMMMjXXMMJ--MjXXXXXXMMMj-XMMMMJX-MMMMMMjXMMMM
-----------XXXXXXXXXXXXXXXXXXXXXXXXXXXXXXXXXXXXXXXXXXXXXXXXXXXXXX--XXXXXXXXXXXX-XXXXXXX-XXXXXXXXXXXX

使用的PROMPT: "no pipes, some enemies, little blocks, many coins,  no rect, high elevation"