---------------------------------------------------------------------------T------------------------
-------------------------TTTTTTT-------------------------------------------T------------------------
-------------------------T--T-TT-------------------------------------------T------------------------
----j---------------------TT-T-T------------------TTTT---------------------T------------------------
-----jj------------------T--TT-T------------------TTTT----------------------------------------------
---j---jjMMM-------------TTT-T-T------------SSSSSST--T---------------------T------------------------
MMj-----XXXX----------------TTTT------------------TT-T---------------------T------------------------
XXX----------------------TTT---T------------------T-TT----------------------------------------------
----------------------------TTTTJM----------------TTTT-----------JM-----jMM-----------JM------------
---------------------------TT-TTTT------?SSSSSSSSS----------jM---<>----jXXXT----------<>-------j----
-------------------------TTTTTTTTT------J-------------------<>---[]---j--------jM-----[]-------X----
----------------------------------------J-------------------[]---[]--j---------<>-----[]-------X----
------------MMMMMMMMMMMMMMMMMMMJ--MMMMMMAMMMMMMMMMMMMMMMMMMj[]MMJ[]MjX-----MMMj[]MMMMJ[]MMMMMMjXMMMM
------------XXXX<>XXXXXXXXXXXXXX--XXXXXXXXXXXXXXXXXXXXXXXXXXXXXXXXXXXX-----XXXXXXXXXXXXXXXXXXXXXXXXX

使用的PROMPT: "some pipes, little enemies, no blocks, no coins,  no rect, high elevation"