----------------------------------------------------------------------------------------------------
---------------------------------------------------------------------------------TTTT------------TTT
----------------------TTT--------------------------------------------------------TTTT------------TTT
----j-----------------TT--------------TTTTTTT------------------------------------TTTT------------TTT
-----jj--XXX---E------TT--------------TT-TTTT------E-----------------------------TTTT---------------
---j---jjMMM----------TTT-------------TT-TTTT-----SSSS---------------SS----------TTTT---------------
MMj-----XXXX----------TT--------------TT--T-T-----]-------------------------------------------------
XXX-------------------TTT-------------TTTTTTT-----]-----------------------------------------X--o----
--X-------------------TTT-------JM----------------]--------------JM-----jMM-----------JM----X-E-----
--X------------------E---XX-----XX------?---------]SSSSS----jM---XX----jXXX-----------<>----XSSjX---
-------------E----E--E------E-----------J--------E]---------<>---XX---j-X------jM-----[]-------XX---
-------------E----------------E---------J---------E---------[]---XX--j--X------<>-----[]-------XX---
------------MMMMMMMMMMMMMMMMMMMJ--MMMMMMAMMMMMMMMMMMMMMMMMMj[]MMJXXMjB--X--MMMj[]MMMMJ[]MMMMMMjXMMMM
-----------XXXXXXXXXXXXXXXXXXXXX--XXXXXXXXXXXXXXXXXXXXXXXXXXXXXXXXXXXX--X--XXXXXXXXXXXXXXXXXXXXXXXXX

使用的PROMPT: "little pipes, many enemies, no blocks, little coins,  some rect, high elevation"