--------------------TTTTT---------------------------------------------------------------------------
--------------------TT--T------------------------------------------TTTTTTTTTTTTTT-------------------
--------------------T--TT------------------------------------------T-TT----T----T-------------------
----j---------------T-T-T----------------------TTT-----------------T--T----TT-T-T--------------TTTTT
-----jj-------------T--TT----------------------TTT-----------------TT-TTTTTT-TT-T--------------TTT-T
---j---jjMMM----EE--TTTTT----------TTTTTTT-E---T--E----------------TTTTTTTTTTTTTT--------------TTTTT
MMj-----XXXX--------TT-TT----------T-T--TT-----T-TSSS------------------------------------------TTTTT
XXX-----------------TT-------------T-TT--T-----TTT---------------------------------------------TTTTT
--------------------TTTTT-------JM-TT--TTT-----------------------JM-----jMM-----------JM------------
--------------------------------XX-TTTTTTT--------QQQQ------jM---XX----jXXX-----------XX-------j----
-----------------------------E--XX------J-------------------XX--------jXX---E--jM--------------X----
----------------------------------------J-----------E----------------jX--------XX--------------X----
------------MMMMMMMMMMMMMMMMMMMJ--MMMMMMAMMMMMMMMMMMMMMMMMMj--MMJ--Mj-X----MMMj--MMMMJ--MMMMMMjXMMMM
------------XXXXXXXXXXXXXXXXXXXX--XXXXXXXXXXXXXXXXXXXXXXXXXX--XXX--XX-X----XXXX--XXXXX--XXXXXXXXXXXX

使用的PROMPT: "no pipes, little enemies, little blocks, no coins,  some rect, high elevation"