----------------------------------------------------------------------------------------------------
----------------------------------------------------------------------------------------------------
----------------------------------TTTT---------------------------------------------------------TTTTT
----j-----------------------------T-TT---------------------------------------------------------T-TT-
-----jj---------------------------T-TT---------------------------------------------------E-----T-TT-
---j---jjMMM---S------------------TTTT-----XX----E---------------SS?SS--------SSS---SSSSSS-----T---T
MMjX----XXX<>------------------------------[]---<>-----E---------------------------------------TTTTT
XXXX-------[]------------------------------[]---[]--------------------------------------------------
XXXX-------[]-------------------JM---------[]---[]---------------JM-----jMM----E------JM------------
XXXX-------XXS----X-----Q-------<>-----??--<>---<>----------jM---<>----j<><-----------<>-------j----
--------------------------------[]------J-------------------<>---[]---jB[][----jM-----[]-------B----
------------------B-------------[]------J---E---------B-----[]---[]--jBb[][----<>-----[]-------b----
------------MMMMMMMMMMMMMMMMMMMJ[]MMMMMMAMMMMMMMMMMMMMMMMMMj[]MMJ[]MjBbB[][MMMj[]MMMMJ[]MMMMMMjBMMMM
------------XXXXXXXXXXXXXXXXXXXXXXXXXXXXXXXXXXXXXXXXXXXXXXXXXXXXXXXXXXXXXXXXXXXXXXXXXXXXXXXXXXXXXXXX

使用的PROMPT: "many pipes, many enemies, no blocks, no coins,  some rect, low elevation"