----------------------------------------------------------------------------------------------------
-----------------------------------------------------------------------------------?----------------
----------------------------------------------------------------------------------------------------
----j-----------------------------------------------------------------------------------------------
-----jj--------------------------------------------EEE----------------------------------------E--E--
---j---jjMMM-------E--X----------------EE--E-------SSSS-S----S----------------Q?QQQQQQ?QQQQQQQQQQQQQ
MMj----XXXSS-------------XX---------------<>------------------------------------------E-------------
XXX------------------------------------E--[]----------------------------XX-----E-E---E---E----------
--X-------------------E---------JM--------[]-------EE------------JM-----jMM-------E---JM------------
-EX-------E---------XSSSS-------<>-----??QQQ-------SSSSS----jM---XX----jXXX-----SSSSS-SSS------j----
SSX---------B---------------E---[]----Q-J---E--E------------<>---XX---jXXXX----jM-----------E--X----
--X-------B-b----E-E--EE--------[]------J-------B----E--E---[]---XX--jXXXXX----B---------------X--E-
--X-------b-MMMMMMMMMMMMMMMMMMMJ[]MMMMMMAMMMMMMMMMMMMMMMMMMj[]MMJXXMjBXXXXXMMMjb-MMMMJ--MMMMMMjXMMMM
E-XXXXXXXXX-XXXXXXXXXXXXXXXXXXXXXXXXXXXXXXXXXXXXXXXXXXXXXXXXXXXXXXXXXXXXXXXXXXXX-XXXXXXXXXXXXXXXXXXX

使用的PROMPT: "little pipes, little enemies, many blocks, no coins,  many rect, low elevation"