-------------------------------------------------T--------------------------------------------------
---------------------------------TTTT------------T--------------------------------------------------
---------------------------------TTTT--------E---T---------------------------------------------<>---
SS--j------B---------------------TTTT-------<>---TTTTT-------------------------<>--------------[]---
-----jj----b---------------------TTTT-------[]-----TTT-------------------------[]--------------[]---
---j---jjMMM-------------SXS----------S----E[]-----TTT---------E---------------XS-------X------[]---
MMj<E---XXXS--------------[]----E---------<><]----------E-----<>-------------------------------<>---
XXX[o---XXX--------E------[]--------------[][]---------<>------------------------------------X-[]---
XXX[]---X----EE---<>------[]----JM--------[][]-------E-[]E-------JM-----jMM-----------JM-----X-<>---
XXX[]---X----<>---[]---SS-<>----<>------?SXXXXS-S------XXX--jM---<>----jBSS-----------XS-----X-j]---
XXX<]---X----[]---<>------------[]------J-------E--E--------<>---[]---jBb------jM-----X---E--B-<>---
XXX[]---X--E-[]---------E---BE--[]------J---------------B---[]---[]--jBbB-B----<>-----X------b-[]-B-
XXX[]---X--EMMMMMMMMMMMMMMMMMMMJ[]MMMMMMAMMMMMMMMMMMMMMMMMMj[]MMJ[]MjB[][][MMMj[]MMMMJX-MMMMMMj[MMMM
XXXXXXX-XXX-XXXXXXXXXXXXXXXXXXXXXXXXXXXXXXXXXXXXXXXXXXXXXXXXXXXXXXXXXXXXXXXXXXXXXXXXXXXXXXXXXXXXXXXX

使用的PROMPT: "many pipes, many enemies, many blocks, many coins,  little rect, high elevation"