----------------------------------------------------------------------------------------------------
-------------------------T----------------------------------------------------------------TTTT------
-------------------------T----------------------------------------------------------------TTTT------
----j--------------------T----------------------------------------------------------------TTTT------
-----jj------E-----------T------------------------------E-------oooo-----------oooooo---------------
---j---jjMMM----XX-------T---XXX-----E------E---------SSSSS------X------------SSSSSSS---------------
MMj-----XSSS----<]-------T---[]-----<>-----<>---------[]---------X----------------------------------
XXX-----------o-[]-------T---[]-----[]ooo-o[]---------X]-----------------E--------------------------
--X----------E--[]-----------[]-JM--[]ooooo[]----o----X----------JM-----jMM-----------JM------------
--X-----SSSSSS--<>-E---------<>-<>--XXXXXSSSX--SSS----------jM---SS----jBSS---S----SS-<>-------j----
--------------------------E--<>-[]------J-------------E-----<>--------j<>------jM-----[]-------B----
--E----------------------------E[]------J---E---------B-----[]-------j-[]------<>-----[]-------b----
-<>-------EEMMMMMMMMMMMMMMMMMMMJ[]MMMMMMAMMMMMMMMMMMMMMMMMMj[]MMJ--MjB-[]--MMMj[]MMMMJ[]MMMMMMjBMMMM
-[]-----XXXXXXXXXXXXXXXXXXXXXXXXXXXXXXXXXXXXXXXXXXXXXXXXXXXXXXXXXXXXXX-XXXXXXXXXXXXXXXXXXXXXXXXXXXXX

使用的PROMPT: "some pipes, many enemies, many blocks, some coins,  little rect, high elevation"