----------------------------------------------------------------------------------------------------
----------------------------------------------------------------------------------------------------
----------------------------------------------------------------------------------------------------
----j-----------------------------------------------------------------------------------------------
-----jj--------------------------------------------------------------------------------E------------
---j---jjMMM-------X-----------------------E-E-------------------SSSSSS---------------SQS-----------
MMjB----B-SS-------X-----SSSS------------------------------------E-----E----------------------------
XXXb----b----------X--------------------------------------------------------------------------------
XXXX-E--B-------X--X------------JM--------------B----------------JM-----jMM-----------JM------------
XXXX----b-----XSXS-X------------<>-----Q?QQ--Q--QQS---------jM---XS----jXXX-----------<>-------j----
XXXX-----EE-------E-------E-----[]------J-------------------XX---X----jXXXX----jM-----[]-------X----
XXXX------------E--SS----XE-----[]------J----------E--------XX---X---jXXXXX----B------[]-------X----
XXXX---E----MMMMMMMMMMMMMMMMMMMJ[]MMMMMMAMMMMMMMMMMMMMMMMMMjXXMMJX-MjXXXXXXMMMjb-MMMMJ[]MMMMMMjXMMMM
XXXXXXXXXXX-XXXXXXXXXXXXXXXXXXXXXXXXXXXXXXXXXXXXXXXXXXXXXXXXXXXXXXXXXXXXXXXXXXXXXXXXXXXXXXXXXXXXXXXX

使用的PROMPT: "little pipes, many enemies, little blocks, no coins,  some rect, low elevation"