----------------------------------------------------------------------------------TTT---------------
--------------------------------------------------------------------------T-------TTT---------------
----------E---------------------------------------------------------------T-------TTT---------------
----j-----E------------------------------------------------------TTTT-----TTTTT---TTT---------------
-----jj---E---oo---oooo--TTTTTT----------oooooo---ooooooo--------TTTT-----T-TTT---TTT---o-----------
---j---jjMMM--EE---XXXXX--TTTTT----------oooooo---XXXXXXX--------TTTT-----T-TTT---TTT--------------o
MMj-----XXXX-------------TTTTTT----------------------------------TTTT------TTTT---TTT--TT----------o
TTT-----------------TT-------------------E---------------------------------------------TT-----------
TTT-----------------TT----------JM-------------------------------JM-----jMM-----------JM------------
TTT-----------------TTT---------XX------?-------------------jM---XX----jXXX-----------XX-------j----
TTT-----------------TTT-----------------J-------------------XX------o-jXXXX----jM--------------X----
TTT------------------------------------EJ----------------------------jX--------XX-------------------
TTT---------MMMMMMMMMMMMMMMMMMMJ--MMMMMMAMMMMMMMMMMMMMMMMMMj--MMJ--Mj------MMMj--MMMMJ--MMMMMMj-MMMM
TTT--------XXXXXXXXXXXXXXXXXXXXX--XXXXXXXXXXXXXXXXXXXXXXXXXX--XXX--XX------XXXX--XXXXX--XXXXXXX-XXXX

使用的PROMPT: "no pipes, little enemies, some blocks, some coins,  little rect, high elevation"