----------------------------------------------------------------------------------------------------
----------------------------------------------------------------------------------------------------
---------------------------------------------------------------------------TT-----------------------
----j-----------------------------------------------------------------------T-----------------------
-----jj-----------------------------------E-E-----------E------------------TT-----------------------
E--j---jjMMM------XXX-------X--------QQQQQQQQQQQQ-----SSSS-------------SSS--T----SS-----------------
MMjB----XXXX--------E--------------------------------------------E-------------------E--------------
XXXX----XXXX------------------------------E--E----------------------------E-------------------------
XXXX--E-XXXX-------X-E----------JM---------------------E---------JM-----jMM--E--------JM--------Q---
XXXX----XXXX-------XSSSSS-------SS-----S?SSSSSSSSS----SSSS--jM---XX----jXSS-----------XX-------j----
XXXX----XXXX----B-----------------------J--------------E----XX---XX---jXX------jM-----X--------B----
XXXX----XXXX----b------EE---------------J-------------------XX---XX--jXXX------XX-----X--------bB---
XXXX----XXXXMMMMMMMMMMMMMMMMMMMJ--MMMMMMAMMMMMMMMMMMMMMMMMMjXXMMJXXMjBXXX-EMMMjXXMMMMJX-MMMMMMjBMMMM
XXXXXX--XXXXXXXXXXXXXXXXXXXXXXXXXXXXXXXXXXXXXXXXXXXXXXXXXXXXXXXXXXXXXXXXXXXXXXXXXXXXXXX-XXXXXXXXXXXX

使用的PROMPT: "no pipes, many enemies, no blocks, many coins,  many rect, high elevation"