--------------------------------------------------------------------------------TTTT----------------
-<>-----------------------------------------------------------------------------TTTT------TTTT--T---
-[]---------------------------------------------------------------------------?-TTTT------TTTT--T---
-[]-j---------------------------------------------TTT-------------oooo----------TTTT------TT-T--T---
-XX--jj----------------oo--------oo----oooooo-----TTT---------------oooo--------TTTT------TT-T--T---
---j---jjMMM----------E----------------X----E-----TTT--------------SS--------XX-TTTT------TTTT--T---
MMj-----XSSS-------------ooooooo-----------<>-----TTT-----------------------------------------------
XXX-----------------------ooooooo----------[]-----TTT--------E-E------------------------E-----------
--X-------oo------ooo----------oJM------?oo[]-----TTT-------E--E-JM--E--jMM-----------JM--------B---
--X-------oo-------oo----------<>X-----S?-SSXSS---TTT-------jM---<>----jBSS-----------<>-------j[---
-oo---------------EE-----------[]X------J-------------------<>---[]---jBb------jM-----[]------EXX---
-oo----o-----------------------[]X------J--E------B---------[]---[]--j<>ooo----<>-----[]-------XX---
--o----o--E-MMMMMMMMMMMMMMMMMMMJ]XMMMMMMAMMMMMMMMMMMMMMMMMMj[]MMJ[]Mj-[]oooMMMj[]MMMMJ[]MMMMMMjXMMMM
-XXX--XXXXX-XXXXXXXXXXXXXXXXXXXXXXXXXXXXXXXXXXXXXXXXXXXXXXXXXXXXXXXXX-XXXXXXXXX[]XXXXXXXXXXXXXXXXXXX

使用的PROMPT: "little pipes, many enemies, little blocks, many coins,  many rect, high elevation"