-TTT------------------------------------------------------------------------------------------------
-TTT----------------------------------------------ooo-------------------------------TTTTTTT---------
-TTT--X-----------------T--TTTTTT-----------------XXXX----ooo-----------------------TTT---T---------
-TTTj--------------ooo--T--TT---T---------------------------------------------------T--T--T---------
-TTT-jj------------ooo--T--T-TT-T---------ooo------------oo-------o-----------------T-T-T-T---oo----
---j---jjMMM-------XXX--T--TTT-TT------------------------XXX------X-o---------------T--T-TT--------o
MMj-----XXXX--ooo-------T--TTTTTT--------oooo-----------------------o--o------------TTTTTTT--------o
XXX---------------------T----------------oo-------------------------oo------ooo--------------ooo----
--------------------------------JM-------------------------------JM--o--jMM----o------JM------------
-o------------------------------<>------?Q------------------jM---XX----jXXX-----------<>-------j----
-o------------------------------[]------J-------------------XX--------j--------jM-----[]-------X----
-o------------------------------[]------J----------------------------j---------XX-----[]-------X----
-o----o-----MMMMMMMMMMMMMMMMMMMJ[]MMMMMMAMMMMMMMMMMMMMMMMMMj--MMJ--Mj------MMMjXXMMMMJ[]MMMMMMjXMMMM
-XXXXXX----XXXXXXXXXXXXXXXXXXXXXXXXXXXXXXXXXXXXXXXXXXXXXXXXX--XXX--XX------XXXXXXXXXXXXXXXXXXXXXXXXX

使用的PROMPT: "little pipes, no enemies, little blocks, little coins,  many rect, high elevation"