-------------------------TTT-----------------------------------------------T------------------------
--------------------------TT-------TTTTT----------TTTTTT-------------------T-----------------TTTT---
--------------------------TT-------T--TT----------TT---T-------------------T---TTTT----------TTTT---
----j---------------------TT-------T---T----------T--T-T-------------------T---TTTT----?-----TTTT---
-----jj------------------TTT-------TTTTT----------T-TT-T-------ooooo-----o-T---TTTT----------TTTT---
---j---jjMMM-----------------------TTTTT----------TT---T-------------------T---TTTT----------TTTT---
MMj-----XXXX----ooooo---------------------ooooooooTTTTTT----------------oo-T------------------------
XXX-----X---------------------------------------------------------------o--T------------------------
--------------------------------JM-------------------------------JM-----jMM-----------JM------------
o-------------------------------<>------?-------------------jM---<>----jXXX-----------XX-------j----
o-------------------------------[]------J-------------------<>---[]---j--------jM--------------X----
oo------------------------------[]------J-------------------[]---[]--j---------XX--------------X----
ooo---o-o---MMMMMMMMMMMMMMMMMMMJ[]MMMMMMAMMMMMMMMMMMMMMMMMMj[]MMJ[]Mj------MMMjXXMMMMJ--MMMMMMjXMMMM
XXX---X-XX--XXXXXXXXXXXXXXXXXXXXXXXXXXXXXXXXXXXXXXXXXXXXXXXXXXXXX[]XX------XXXXXXXXXXX--XXXXXXXXXXXX

使用的PROMPT: "some pipes, no enemies, little blocks, some coins,  many rect, low elevation"