-------------------------------------------------------------------TTTT-----------------------------
-------------------------------------------------------------------TTTT-----------------------------
--------------------------TTTT-T---------------------XXXXXXX-------TTTT----SSSSSSSSSSSSSSSSSSSSSSSSS
----j--------------E------TTTT-T----TTTT-------------[]--[]--------TT-T------[]---------------[]----
-----jj-----------<>------TTTT-T----TTTT-------------[]--[]--------TT-T------[]---------------[]----
---j---jjMMM------[]------TTTT-T----TTTT---------X---[]--[]--------TTTTT-----[]----------TTT--[]----
MMjX----<>SS------[]------TTTT-T----TTTT----------SS-[]--[]------------------<>---------------<>----
XXX-----[]--------[]----------------TTTT----oo-------[]--[]-------------------------------------S-SS
X-X-----[]--------[]------------JM-------------------[]--XX------JM-----jMM-----------JM----------SS
X-X-----[]--------[]------------<>------?SSSS--------<>-----jM---<>----jSSS-----------<>-------j----
--------[]--------<>------------[]------J-------------------<>---[]---j>-------jM-----[]-------<>---
--------[]----------------------[]------J-------------E-----[]---[]--j<]-------<>-----[]-------[]---
-------E[]--MMMMMMMMMMMMMMMMMMMJ[]MMMMMMAMMMMMMMMMMMMMMMMMMj[]MMJ[]Mj-[]---MMMj[]MMMMJ[]MMMMMMj[MMMM
-XXXXXXXXXXXXXXXXXXXXXXXXXXXXXXXXXXXXXXXXXXXXXXXXXXXXXXXXXXXXXXXXXXXX-[]XXXXXXXXXXXXXXXXXXXXXXXXXXXX

使用的PROMPT: "many pipes, some enemies, little blocks, many coins,  no rect, high elevation"