----------------------------------------------------------------------------------------------------
o-------------------------------------------------TTTT----------------------------------------------
------------------------------------------TTTTT---TTTT----------------------------------------------
----j-------------------------------------TTTTT---TTTT----------------------------------------------
-----jj------------ooo------------oooooo-oTTTTT---TTTT--------------------o-----oooooo--------------
---j---jjMMM-----XXXXX--------------------TTTTT--------------------------SS-----XXXXXX--------------
MMjX----XSSS-----X------------------------TTTTT-------ooooooooo-------------------------------------
XXXX----XSSS--X--X----------------------------------------------------------------------------------
XXXX----XSSS--X--X--------------JM-------------------------------JM-----jMM-----------JM------------
XXXX----XSSS--X--X--------------<>------?---------SSS-------jM---SS----jXXX-----------XX-------j----
---X----XSS---X-----------------[]------J-------------------SS--------jXX------jM-----X--------X----
---X----XSS---------------------[]------J--------------------S-------jXXX------<>-----X--------X----
---X----XSo-MMMMMMMMMMMMMMMMMMMJ[]MMMMMMAMMMMMMMMMMMMMMMMMMj-SMMJ--MjXXXXooMMMj[]MMMMJX-MMMMMMjXMMMM
---X----XXX-XXXXXXXXXXXXXXXXXXXXXXXXXXXXXXXXXXXXXXXXXXXXXXXX-XXXXXXXXXXXXXXXXXXXXXXXXXX-XXXXXXXXXXXX

使用的PROMPT: "some pipes, no enemies, many blocks, some coins,  many rect, low elevation"