--------------------------------------------------TT-----------------------------------TTTTT--------
------------------------------------------------TTTT-----------------------------------TT-TT--------
------------------------------------------------TTTT-----------------------------------T-TTT--------
----j-------------------------------------------TTTT-----------------------------------TT--T--------
-----jj------XX------o---ooo------ooooo--oo-----TTTT---------------oooooo-oTT----------T-TTT------oo
---j---jjMMM------XXXXXX-XXXX------XXXX---------TTTT---------------XXXXXXXXTT----------TTTTT----XXXX
MMj----XXXXX------------------------------------TTTT-----TTTT--------------TT-----------------------
XXX---------------------------------------------TTTT-----TTTT--------------TT-----------------------
XX------------------------------JM--------------TT-------T-T-----JM-----jMM-----------JM------------
XX------------------------------XX------?----------------T-TjM---XX----jXXX-----------XX-------j----
--------------------------------X-------J----------------TTTXX--------jXX------jM-----X--------X----
--------------------------------X-------J--------------------------X-jXXX------XX-----X--------X----
------------MMMMMMMMMMMMMMMMMMMJX-MMMMMMAMMMMMMMMMMMMMMMMMMj--MMJ--MjXXXX--MMMjXXMMMMJX-MMMMMMjXMMMM
------------XXXXXXXXXXXXXXXXXXXXXXXXXXXXXXXXXXXXXXXXXXXXXXXX--XXX--XXXXXXXXXXXXXXXXXXXX-XXXXXXXXXXXX

使用的PROMPT: "no pipes, no enemies, little blocks, many coins,  little rect, high elevation"