----------------------------------------------------------------------------------------------------
--------------------------------------------------------------------------------------------------TT
------------------------TTTTTT--------------------------------------------------------------------T-
----j-------------------T-TTTT---------------------------------------------TTT--------------------T-
-----jj-----------------TT-T-T---------------------------------------------TTT--------------------T-
---j---jjMMM------------T-T-TT-----------SSSSSSSQS-----------------------X-TTT--------------------T-
MMj-----XXXX------------TTTTTT---------------------------------------------TTT--------------oo----TT
XXX---------------------T--------------------------------------------------TTT--------------------TT
--------------------------------JM-------------------------------JM-----jMM-----------JM------------
--------------------------------<>------?SSSSSSSSS----------jM---XX----jXXX-----------<>-------j----
--------------------------------[]------J-------------------<>--------j--------jM-----[]-------X----
--------------------------------[]------J-------------------[]-------j---------XX-----[]-------X----
--o--o------MMMMMMMMMMMMMMMMMMMJ[]MMMMMMAMMMMMMMMMMMMMMMMMMj[]MMJ--Mj------MMMjXXMMMMJ[]MMMMMMjXMMMM
--XX-X-----XXXXXXXXXXXXXXXXXXXXXXXXXXXXXXXXXXXXXXXXXXXXXXXXXXXXXX--XX------XXXXXXXXXXXXXXXXXXXXXXXXX

使用的PROMPT: "little pipes, little enemies, no blocks, little coins,  no rect, high elevation"