------------------------T---------------------------------------------------------------------------
------------------------T---------------------------------------------------------------------------
------------------------T--------------------------------------------------SSSSSSSSSSSSSSSSSSSSSSSSS
----j-------------------T--------------------------------------------------SSS---------SSSSS--------
-----jj--------------------------------------------------------------------SSS---------SSSSS--E-----
---j---jjMMM----E-SS----------------SS--S------------------------------------------------SSS--------
MMj----XXSSS---<>--[]----------------------------------?QQQ----------E----------------------E-------
X<>-----X------[]--[]----------------------------------E--------------------------------------------
-[]-----X------[]--[]-----------JM-------------------------------JM-----jMM-E---------JM------------
S[]---S-XSSS---XXXSXXSSSS-------<>-----S?--------Q----------jM---XX----jSSS-S---------<>-------j----
S[]-----XS----------------------[]------J--------------E----<>---XX---j-----E--jM-----[]---E---X--XX
S[]-----XSS-----------E---------[]------J-------------------[]---XX--jB--------<>-----[]-------X----
S[]E---EX---MMMMMMMMMMMMMMMMMMMJ[]MMMMMMAMMMMMMMMMMMMMMMMMMj[]MMJXXMjB[]---MMMj[]MMMMJ[]MMMMMMjXMMMM
XXXXXXXXXXXXXXXXXXXXXXXXXXXXXXXXXXXXXXXXXXXXXXXXXXXXXXXXXXXXXXXXXXXXXXXXXXXXXXXXXXXXXXXXXXXXXXXXXXXX

使用的PROMPT: "some pipes, many enemies, no blocks, many coins,  little rect, low elevation"