--------------TTTT-----------------------------------------------------------------------TTTTTTTT---
--------------TTTT-------------------------------------TTTTTT----------------------------T------T---
--------------TTTT------------------------------TT-----TTTTTT--------------TTT-----------T---T--T---
----j---------TTTT------------------------------TT-----TTTTTT----------------T-----------T-TT-T-T---
-----jj-----------------------------------------T------TTTTTT------oo------TTT-----------T-TT---T---
---j---jjMMM-------------------------TTTTT------T----------------------------------------TT---T-T---
MMj-----XXXX-------------------------TTTTT------T----------------------------------oo----TTTTTTTT---
XXX----------------------------ooo---TTTTT------TT-----------------------------------oo-------------
-------------------------------oJM---TTTTT------TT---------------JM-----jMM----------oJM------------
-----------------XXXXXXXX------QQQ---TTTTT------------------jM---<>----jXXX----------E<>-------j----
----------------------------------------J-------------------<>---[]---j--------jM-----[]-------X----
-------------------E--------------------J-------------------[]---[]--j---------<>-----[]-------X----
------------MMMMMMMMMMMMMMMMMMMJ--MMMMMMAMMMMMMMMMMMMMMMMMMj[]MMJ[]Mj------MMMj[]MMMMJ[]MMMMMMjXMMMM
---------XXXXXXXXX<>XXXXXXXXXXXX-XXXXXXXXXXXXXXXXXXXXXXXXXXXXXXXXXXXX------XXXX[]XXXXXXXXXXXXXXXXXXX

使用的PROMPT: "some pipes, little enemies, no blocks, some coins,  some rect, high elevation"