---------------------------------------------------------------------------------------TTTTTT-------
---------------------------------------------------------------------------------------TTT-TT-----TT
--E------------------------------------------------------------------------------------TTT-TT-T---TT
----j----------------------------------------------------------------------------------T--TTT-T---TT
-----jj--------------------------------------------------------------------------------TTTTTT-T---TT
---j---jjMMM--------XX------SSSSS---E-S----?--E---TTTT--SSSS----SS---------------------TTTTTT-T-----
MMjX----XXSS--------[]-------------<>--------<>---TTTT---------------------SS-----------------------
XXXX----XX----------[]-----E-------[]--------[]---TTTT----------------------------------------------
--XX----XX----------[]----------JM-X]--------[]---TTTT-----------JM-----jMM-----------JM------------
--XX----XXSS--------<>----------<>-XX--S?SSSSXXSSS-------E--jM---SS----jSSS-----------XS-------j----
--XX----XX----------------------[]------J---------------E---<>--------jX-------jM-----X--------B----
--XX----XXS----------E----------[]------J---------------E---[]-------jXX-------<>-----X--------b----
--XX----XX--MMMMMMMMMMMMMMMMMMMJ[]MMMMMMAMMMMMMMMMMMMMMMMMMj[]MMJ--MjBXX---MMMj[]MMMMJX-MMMMMMjBMMMM
--XX----XX--XXXXXXXXXXXXXXXXXXXXXXXXXXXXXXXXXXXXXXXXXXXXXXXXXXXXXXXXXXXXXXXXXXXXXXXXXXXXXXXXXXXXXXXX

使用的PROMPT: "some pipes, some enemies, many blocks, some coins,  no rect, low elevation"