----------------------------------------------------------------------------------------------------
----------------------------------------------------------------------------------------------------
---------------------------------------------------------------------------SSSSSSS------------------
----j-----------------------------------------------------------------------------------------------
-----jj---------------------------------------------------------------------------------------------
---j---jjMMM------XXXXX-----QQQ??------SSS?SSS--------------------XXXX------------------------------
MMjX----XXXX-----------------------------------------------------XX---------------------------------
XXX-------------------------------------------------------------------------------------------------
--------------X-----------------JM-------------------------------JM-----jMM-----------JM------------
------------------------------QQQQ-----S?QSSSSSS------------jM---XX----jXXX-----------XX-------j----
------XX---------------------S----------J-------------------XX--------jXX------jM-----XX-------X----
----------------------------------------J----------------------------jXXX------XX-----XX-------X----
------------MMMMMMMMMMMMMMMMMMMJ--MMMMMMAMMMMMMMMMMMMMMMMMMj--MMJ--MjXXXX--MMMjXXMMMMJXXMMMMMMjXMMMM
----------XXXXXXXXXXXXXXXXXXXXXX-XXXXXXXXXXXXXXXXXXXXXXXXXXX--XXX--XXXXXX--XXXXXXXXXXXXXXXXXXXXXXXXX

使用的PROMPT: "no pipes, no enemies, no blocks, many coins,  no rect, high elevation"