----------------------------------------------------------------------------------------------------
---------------------------------------TTTTT-------TTTT--------------------TT-----------------------
--------------------------------TTTT---TTTTT-------TTTT--------------------TT-----------------------
----j---------------------------TTTT---TTTTT-------TTTT---------------------T-----------------------
-----jj-------------------------TTTT---TTTTT-------TTTT---------------------T-----------------------
---j---jjMMM----SSS-------------TTTT------------E--TTTT----XXXX-----SSS-----T-----------------E-----
MMj-----XXXX-----[]-------------TTTT-----------<><---------[]--------------------------------<>-----
XXX--------------[]----------------------------[][---------[]--------------------------------[]-----
-----------------[]-------------JM-------------[][---------[]----JM-----jMM-----------JM-----[]-----
---------------SS[]-------------<>------?------<>[---------<jM---<>----j<><-----------<>-----XXj----
-E---------------<>-------------[]------J--------<----------<>---[]---j<]][----jM-----[]-------<>---
<>------------------------------[]------J------------------------[]--j-[]][----<>-----[]-------[]---
[]----------MMMMMMMMMMMMMMMMMMMJ[]MMMMMMAMMMMMMMMMMMMMMMMMMj--MMJ[]Mj--[]][MMMj[]MMMMJ[]MMMMMMj[MMMM
XXXXXXXXXXXXXXXX<>XXXXXXXXXX<>XXXXXXXXXXXXXXXXXXXXXXXXX<>XXX--XXXXXXX--[]]XXXXXXXXXXXXXXXXXXXXXXXXXX

使用的PROMPT: "many pipes, some enemies, no blocks, some coins,  no rect, high elevation"