----------------------------------------------------------------------------------------------------
----------------------------TTTTTTT------------------TTTTTTTTTTTTT----------------------------------
------------------TTTTTT----T-T-T-T---TTTTTT---------TT--T-T-T---T----------------------------------
----j-------------TT--TT----T-T-T-T---T--T-T---------T-TTTT-T--T-T----------------------------------
-----jj-----------T-T--T----TT-TTTT---T-TT-T---------T--T-T-T-TT-T----------------------------------
---j---jjMMM------T--TTT----TTTTTTT---TTTTTT---------T--T---T----T----------------------------------
MMj----<>XXX------TTTTTT-----------------------------TT--TT-T-TT-T-----------------------------?QQQQ
XXX----[]--------------------------------------------TTTTTTTTTTTTT----------------------------------
--X----[]-----------------------JM-------------------------------JM-----jMM-----------JM------------
--X----[]-----------------------<>------?-------------------jM---<>----j<><-----------<>-------j----
-------[]-----------------------[]------J-------------------<>---[]---jX[][----jM-----[]-------X----
-------[]-----------------------[]------J-------------------[]---[]--jXX[][----<>-----[]-------X----
-------[]---MMMMMMMMMMMMMMMMMMMJ[]MMMMMMAMMMMMMMMMMMMMMMMMMj[]MMJ[]MjXXX[][MMMj[]MMMMJ[]MMMMMMjXMMMM
-------XXXXXXXXXXXXXXXXXXXXXXXXXXXXXXXXXXXXXXXXXXXXXXXXXXXXXXXXXXXXXXXXXXXXXXXXXXXXXXXXXXXXXXXXXXXXX

使用的PROMPT: "many pipes, no enemies, some blocks, no coins,  no rect, high elevation"