--------------------------------------------------
--------------------------------------------------
-----jj-------------------------------------------
MMMMj--j------jj----------------------------------
TTTTT---jMMMMj------------------------------------
TT-TTT--<>XXXX--j--------TTTTT--------------------
TTTT-T--[]---------------T---T---j----------------
-T---T--[]---------------T-TTT--j-j---------------
-T-T-T--[]-------jMMMM---TTTTTJj--X---------------
TT-T-T--[]-------<><><>-------<>-----------------?
TTTTTT--[]-------[][][]-------[]------------jjj--J
--------[]-------[][][]-------[]-----------------J
--------[]-------[][][MMMMMMMJ[]---MMMMMMMMj---jMA
XXXXXXXXXXXXXXXXXXXXXXXXXXXXXXXX---XXXXXXXXX---XXX

使用的PROMPT: "some pipes, no enemies, no blocks, no coins,  some rect, high elevation"