------------------------T-------------------------
------------------------T-------------------------
-----jj-----------------T-------------------------
MMMMj--j------jj--------T-ooo---------------------
XXXXX---jMMMMj-------oooTEooo--------------------o
--------SSSSSS--j-----oo-SSSSS---------------E---o
---------------------------------j------E---------
-X------------------------------j-j-----X---------
-X---------------jMMMM--------JjS-S-----X---------
-XXSSSSSSS-------SSSSS---SSSS-SS--------X--------?
----------E---------------E-----------------jjj--J
-------------------------------------------------J
----E-----------------MMMMMMMJ-----MMMMMMMMj---jMA
----XXXXXXXXX-----XXXXXXXXXXXXXXXXXXXXXXXXXX---XXX

使用的PROMPT: "no pipes, little enemies, some blocks, many coins,  no rect, high elevation"