--------------------------------------------------
------------------------------------TTTTTT--------
-----jj-----------------------------TTTTTT--------
MMMMj--j------jj--------------------TT-T-T--------
TTTTT---jMMMMj----------------------TTTTTT--------
T-TTT---TTTTTT--j----------XXXXX------------------
T-T-T---T--TTT-------------------j----------------
TTT-T---TTTTTT------------------j-j---------------
TTTTT---TTTTTT---jMMMM--------Jj--S---------------
-----------------<><>S--------<>-----------------?
-----------------[][]---------[]------------jjj--J
-----------------[][]---------[]-----------------J
-----X-------XX--[][]-MMMMMMMJ[]---MMMMMMMMj---jMA
XX---XXXXXXXXXXXXXXXXXXXXXXXXX[]---XXXXXXXXX---XXX

使用的PROMPT: "many pipes, no enemies, no blocks, no coins,  some rect, low elevation"