--------------------------------------------------
--------------------------------------------------
-----jj---------------------------------TTTT------
MMMMj--j------jj------------------------TTTT----TT
XXXXX---jMMMMj----------o---------------TTTT----TT
--------XXXXXX--j-------XSSSSS----------TTTT----TT
---------------------------------j------TTTT----TT
--------------------------------j-j-------------TT
-----------------jMMMM--------JjS-S-------------TT
XXXXXX-----------XXXXX----SSSSSS-------XSS------TT
--------------------------------------------jjj--J
-------------------------------------------------J
----------------------MMMMMMMJ-----MMMMMMMMj---jMA
------------------X---XXXXXXXXXXXXXXXXXXXXXX---XXX

使用的PROMPT: "no pipes, no enemies, many blocks, some coins,  no rect, low elevation"