-------------------------TTT----------------------
--------------------------TT----------------------
-----jj------------------TTT-------------------TTT
MMMMj--j------jj---------TTT-------------------T--
XXXXX---jMMMMj-----------TTT-------------oooo--T-T
--------XXXXXX--j-------------------------XXX--T-T
---------------------------------j----XX-------T--
--------------------------------j-j------------TT-
-----------------jMMMM--------Jj--X------------TTT
-----------------XXXXX--------XX------------------
------------------------------XX------------jjj--J
------------------------------XX-----------------J
----------------------MMMMMMMJXX---MMMMMMMMj---jMA
----------------------XXXXXXXXXX---XXXXXXXXX---XXX

使用的PROMPT: "no pipes, no enemies, many blocks, some coins,  little rect, low elevation"