-------------------------------------------TTTTTT-
-------------------------------------------TTTTTT-
-----jj------------------------------------TTTTTT-
MMMMj--j------jj---------------------------TTTTTT-
XXXXX---jMMMMj------------------------------------
--------XXXXXX--j--XXX----------------------------
-o------------------------oo-----j----------------
-------------------------X------j-j---------------
-----------------jMMMM--------Jj--?---------------
-----X------XXXX-XXXXX--------<>-----------------?
------------------------------[]------------jjj--J
------------------------------[]-----------------J
----------------------MMMMMMMJ[]---MMMMMMMMj---jMA
XXXXXXXXX----------XXXX<>XXXXXXXXXXXXXXXXXXX---XXX

使用的PROMPT: "many pipes, no enemies, little blocks, little coins,  little rect, low elevation"