TTTT----------------TTTT--------------------------
-TTT----------------TTTT--------------------------
-TTT-jj-------------TTTT--------------------------
MMMMj--j------jj----TTTT--------------------------
SSSSS---jMMMMj-----------T------------------------
--E-----SSSSSS--j--------T------------------------
-------------------------T-------j----------------
--------------------------------j-j---------------
--------oooo-----jMMMM--------JjS-S------E----oo--
-XXXXX---ooo-----XXXXX--------SS---------E-------?
---------ooo-----XXX--------E---E--------E--jjj--J
-----------------XXX---------------E-------------J
-o---------------XXX--MMMMMMMJ-----MMMMMMMMj---jMA
XXXXX------------XXX--XXXXXXXX--X-XXXXXXXXXX---XXX

使用的PROMPT: "no pipes, little enemies, many blocks, little coins,  many rect, low elevation"