----------------------------------------------------------------------------------------------------
-------------------------TTTTT------------TTTTT-----------------------------------------------------
-------------------------T---T------------TT-TT---------------------T-----------------TTTTT---------
----j--------------------T-T-T------------TT-TT---------------------T----oo-----------TT-TT------o--
-----jj-------------oooooT-T-T------------T-TTT---------------------T-----------------T-T-T---------
---j---jjMMM--------ooooo-T-TT------------T-TTT-------------XX------T------S----------TT-TT---------
MMjX----TTTT-------oooo>-TTTTT------------T--TT-------------oo------------------------TT-TT---------
TTTX----TTTT-----------]------------------TT-T-------------oooo--------------TTT-XX-----------------
TTTX-----TT---------------------JM--------TTTTT---------ooo------JM-----jMM--TTT------JMTTT---------
--TX-----TTT--------------------<>------?----------------XX-jM---<>----jXXX--TTT------<>-------j----
--T-----------------------------[]------J-------------------<>---[]---jXXXX--TTjM-----[]-------<----
-TT-----------------------------[]------J-------------------[]---[]--jXXXXX----<>-----[]-------[----
TTT-------<-MMMMMMMMMMMMMMMMMMMJ[]MMMMMMAMMMMMMMMMMMMMMMMMMj[]MMJ[]MjXXXXXXMMMj[]MMMMJ[]MMMMMMj[MMMM
---------XXXXXXXXXXXXXXXXXXXXXXXXXXXXXXXXXXXXXXXXXX<>XXXXXXXXXXXXXXXXXXXXXXXXXXXXXXXXXXXXXXXXXXXXXXX

使用的PROMPT: "many pipes, no enemies, many blocks, little coins,  little rect, low elevation"