----------------------------------------------------------------------------------------------------
--------------------------------<-------------------------------------------------------------------
SS-------E----------------------[]-----------------------------E--------------TTTTT-----------------
----j---------------------------[]----------------------------<>--------------TTT-T-----------------
-----jj-----E-------------------[]--E---------------E-------<>[]--------------TTTTT-----------E-----
---j-B-jjMMM-------E---E------E-QQQQQ-------------QQ?-------[]XX----------------------------SSS-----
MMjS-S---SSS------<>--<>-----<>-----------------------------[]X---E-------------------------[]------
SSS---------------[]--[]-----[]----E------------------------<>------------------------------[]------
-----------E------[]--[]-----XX-JM-------------------------------JM-----jMM-----------JM----[]------
--E-------SS------XX--XX--------<QQQQQQQ?-------------------jM---<>----jBXX-----------<>----[]-j----
--------------E-------------------------J-----------------B-<>---[]---j-bXX-S--jM-----[]----<>-<----
-------------------------E--------------J-----B------B--B-b-[]---[]--j--XXX----<>-----[]-------[----
-B----------MMMMMMMMMMMMMMMMMMMJE-MMMMMMAMMMMMMMMMMMMMMMMMMj[]MMJ[]MjX--XXXMMMj[]MMMMJ[]MMMMMMjBMMMM
-XX--------XXXXXXXXXXXXXXXXXXXXXXXXXXXXXXXXXXXXXXXXXXXXXXXXXXXXXXXXXXX--XXXXXXXXXXXXXXXXXXXXXXXXXXXX

使用的PROMPT: "many pipes, many enemies, many blocks, some coins,  no rect, low elevation"