----------------------------------------------------------------------------------------------------
-E---------TTTTTTTTTTTTTT---------------------------------------------------------------------------
-E---------TT-TT---TTT-TT---------------------------------------------------------------------------
----j------TT--TT-T-TT--T--------------------------E-----------------------T-------TTT--------------
-----jj----T-T-T-T-TTTTTT--------------------------------------------------T-------TT---------------
---j---jjMMM--TTTTTTTTTTT-----TTTTT--------------------------------E---------------TTT--------------
MMj-----XXXX-------------------TTTT-------------------------XXX---E-------ET-------TTT--------------
TTT-----XXXX--------------------------------------------------------------E--------TTT--------------
TTT-----XX----------------------JM-------------------------------JM-----jMM-------ETTTJM------------
--T-----XXX------------------XX-XX--------------------------jM---XX----j-XX-----------<>-------j--X-
--T-----X-------------------------------J------XX-----------XX--------j----E---jM-----[]-------X----
---------------------E-----------------EJ-----------E-------XX-------j---------<>-----[]------------
------------MMMMMMMMMMMMMMMMMMMJ-EMMMMMMAMMMMMMMMMMMMMMMMMMjXXMMJ--MjX-----MMMj[]MMMMJ[]MMMMMMj-MMMM
------------XXXXXXXXXXXXXXXXXXXX-XXXXXXXXXXXXXXXXXXXXXXXXXXXXXXXX--XXX-----XXXXXXXXXXXXXXXXXXXX-XXXX

使用的PROMPT: "little pipes, little enemies, little blocks, no coins,  little rect, low elevation"