TTTTTTTTTTT------------------TTT--------------------------------------------------------------------
TTTTTT-TTTT------------------TTT------------------------TTTTT---------------------------------------
TTT-TT-TTTT------------------TTT------------------------TTTTT---------------------------------------
TTT-jT-TTTT------------------TTT------------------------TTT-T---------------------------------------
TTTT-jj----------------------TTT------oo----------------TTT-T-------------------------o-------------
TTTj---jjMMM-----------------TTT-----XXXXXX-------------TTTTT------------------------ooo------------
MMjX----<>XX-----------------TTT---ooooo----------------TTTTT--------------------------------------o
-XXX----[]-------oooooooo----------oooooooo-------------------------------------------------------oo
--------[]------oo----Xoo-------JM-------------------------------JM-----jMM-----------JM----------XX
--------[]------XX-----XX-------<>-----??-------------------jM---XX----jSSS-----------SS-------j---X
--------[]----------------------[]-----?J-------------------<>--------jS-------jM-----SS-------X----
--------[]----------------------[]------J-------------------[]-------jX--------<>-----SS-------X----
--------[]--MMMMMMMMMMMMMMMMMMMJ[]MMMMMMAMMMMMMMMMMMMMMMMMMj[]MMJ--MjXX----MMMj[]MMMMJSSMMMMMMjXMMMM
--------XXXXXXXXXXXXXXXXXXXXXXXXXXXXXXXXXXXXXXXXXXXXXXXXXXXXXXXXX--XXXXXXXXXXXXXXXXXXXXXXXXXXXXXXXXX

使用的PROMPT: "many pipes, no enemies, little blocks, some coins,  some rect, low elevation"