----------------------------------------------------------------------------------------------------
-------------------------------------------------------------------------------------?QQ------------
Eooooo---------------------------------------------TTTTTTTTT-------------oo-------------------------
----j----------------------------------------------T-T-T-TTT----------------------------o-----------
-----jj---------------E---------------------E--Eoo-T--T-TT-T----------------o---ooooo----oooooooooo-
---j---jjMMM--------oQQQQ-----------SSSSSSSSSSSSSS-TTTTTTTTT---------------SSSSSSSSSSSSSSSSSSSSSSSSS
MMjX----XXXX-----------------SSS--------------------------------------------------------------------
XXXX----------------------------------------------o-------------------------------------------------
--------------------------------JM------------oo--X--------------JM-----jMM-----X-----JM------------
S-------------------XXXXX-------SS----???---------XXXXXXXXXXjM---XX----j-XXSSSSSXXXXSSSS-SSSSS-j----
------------------------------E---------J-------------------<>--------j--------jM--------------SSSSS
o----------------------------E----------J-------------------[]-------j--o------<>----------E--------
------------MMMMMMMMMMMMMMMMMMMJ--MMMMMMAMMMMMMMMMMMMMMMMMMj[]MMJ--MjX-----MMMj[]MMMMJ--MMMMMMj-MMMM
---XXXXXXXXXXXXXXXXXXXXXXXXXXXXX--XXXXXXXXXXXXXXXXXXXXXXXXXXXXXXX--XXX-----XXXXXXXXXXXXXXXXXXXXXXXXX

使用的PROMPT: "little pipes, little enemies, little blocks, many coins,  no rect, high elevation"