---------------------TTTT---------------------------------------------------------------------------
---------------------TTTT---------------------TTTT------------------------------------------------TT
---------------------TTTT-TTTTTTTT------------TTT--------------------------SSSSSSSSSSSSSSSSSS-----TT
----j----------------TTTT-TT-T-T-T------------TTT----------------------------[]--[]--------[]-----TT
-----jj-------------------TT-T-TTT------------TTTT-E-------------------------[]--[]--------[]-----TT
---j---jjMMM-----<>-------TT-T--TT-------E--------SS--------XX---------?SSS--[]--[]--------[]-----TT
MMjS----<>SS-----[]-------TT-TT-TT------<>---E<>------------[X---------------[]--[]--------[]-----TT
TTT-----[]-------[]--<>---TT-T----------[]--<>[]------------XX---------------[]--[]--------[]-----TT
TTT----<>--------[]-<[]---TTTTT-JM------[]--[][]--X----------X---JM-----jMM--[]--[]---JM---[]-----TT
TTT----[]--------<Q--XXXX-------<QQQ----<>--QQQQQQXX--------jM---<>----jB?Q-SSS--[]---<>---<>--j----
TTT----[]---------------------B-[-------J---------------E---<>---[]---jXX------jM<>---[]-------B----
-------<]---------------------B-<-------J-------------------[]---[]--jXXX------<>-----[]-------b----
------B[]-EEMMMMMMMMMMMMMMMMMMMJ--MMMMMMAMMMMMMMMMMMMMMMMMMj[]MMJ[]MjXXXXB-MMMj[]MMMMJ[]MMMMMMjBMMMM
---XXXXXXXXXXXXXXXXXXXXXXXXXXXXXXXXXXXXXXXXXXXXXXXXXXXXXXXXXXXXXXXXXXXXXXXXXXXXXXXXXXXXXXXXXXXXXXXXX

使用的PROMPT: "many pipes, many enemies, some blocks, no coins,  some rect, high elevation"