----------------------------------------------------------------------------------------------------
------------------TTTTTT----------------------------------------------------------------------------
-----Eoo----------TTT--T----------------------------------------------------------------------------
----j------o------TTT-TT----------------------------------------------------------------------------
-----jj-----------TTT-TT--------------------------o------------------------------Eooo---------------
---j---jjMMMT--------TTT--------------------------o---E-------------------------XXXXX---------------
MMj---TTTTTTT------------------------Eo--------------Eooo----EE-------------------------------------
TTT---TTTTTTT--------------------E-oo--------o------------------------------------------------------
TTT---TTTT-TT---------E---------JM------------------o------------JM-----jMM-----------JM------------
TTT---TTTTTTT-------------------EX------?----E----SSS-E-----jM---XX----jXXX-----------XX-------j----
TTT---TTTTTTT----------------E-------E--J----E-------------E----------jXX---E--jM-----XX-------X---E
TTT---TTTTTTT----------------E----------J----------------------------jXXX---E--<>--------------X----
TTT---------MMMMMMMMMMMMMMMMMMMJ--MMMMMMAMMMMMMMMMMMMMMMMMMj--MMJ--MjXXXX--MMMj[]MMMMJ--MMMMMMjXMMMM
-XX--------XXXXXXXXXXXXXXXXXXXXX--XXXXXXXXXXXXXXXXXXXXXXXXXX--XXX--XXXXXX--XXXXXXXXXXX--XXXXXXXXXXXX

使用的PROMPT: "little pipes, little enemies, some blocks, some coins,  little rect, low elevation"