---------------------------------------------------------------------T------------------------------
----------------------------------------------------TTTT-------------T-----------TTT----------------
-------------------------------------SSSSSSSSSSSSS--TTTT-----TT------T-----------T-T----------------
----j-----------------------------------------------TT-T-----TT------T-----------T-T----------------
-----jj-------------------oooo----------------------TT-T-----TT------T---oo------TTT----------------
---j---jjMMM-----X-------SSSSSSSSSSSSS---------ooo--TT-T-----TT------T--SSS------TTT---SSS-SSS------
MMjX----XXXX--------------------------------o>o-----TTTT-----TT-------------------------------------
XXXX----------------------------------------oo-o----TT-T-----TT-------------------------------------
XXXX----------------------------JM------------o-----TT-T---------JM-----jMM-----------JM------------
XXXX----------------------------<>------?-----SSSS--TTTT----jM---XX----j<>S-----------<>-------j----
--XX----------------------------[]------J-----------TTTT----<>--------jX[]S----jM-----[]-------<----
--XX----------------------------[]------J-------------------[]-------jXX[]-----<>-----[]-------[----
-SXX-------oMMMMMMMMMMMMMMMMMMMJ[]MMMMMMAMMMMMMMMMMMMMMMMMMj[]MMJ--MjXXX[]-MMMj[]MMMMJ[]MMMMMMj[MMMM
XXXXXXXXXXXXXXXXXXXXXXXXXXXXXXXXXXXXXXXXXXXXXXXXXXXXXXXXXXXXXXXXX-XXXXXXXXXXXXXXXXXXXXXXXXXXXXXXXXXX

使用的PROMPT: "little pipes, no enemies, many blocks, many coins,  no rect, high elevation"