----------------------------------------------------------------------------------------------------
----------------------------------------------------------------------------------------------------
----------------------------------------------------------------------------------------------------
----j-----------------------------------------------------------------------------------------------
-----jj--------------------------------------------------------------------E-----------------SS-----
---j---jjMMM---------------XX----------------------------------------------QQ------------------SS---
MMjS----TTTT---------------------------------------------------E----------Q--S----------------------
SSS-----T-TT-------------------------------------------------------------Q--------------------------
--------TT-T-----SS-------------JM-------------------------------JM-----jMM-----------JM------------
---------TTT-------------Q------<>----S-?Q---------------SSSjM---<>----jXXX--S--------QQ-------j----
--------------------------------[]------J-------------------XX---[]---jXXXX----jM--------------<----
--------------------------X-----[]------J-------------------XX---[]--jXXXXX----<>--------------[----
---------B--MMMMMMMMMMMMMMMMMMMJ[]MMMMMMAMMMMMMMMMMMMMMMMMMjXXMMJ[]MjXXXXXXMMMj[]MMMMJ--MMMMMMjBMMMM
---XXXXXXX--XXXXXXXXXXXXXXXXXXXXXXXXXXXXXXXXXXXXXXXXXXXXXXXXXXXXXXXXXXXXXXXXXXXXXXXXXXXXXXXXXXXXXXXX

使用的PROMPT: "some pipes, many enemies, no blocks, no coins,  no rect, low elevation"