--------------------------------------------------
--------------------------------------------------
-----jj-------------------------------------------
MMMMj--j------jj----------------------------------
TTTTT---jMMMMj-----------------------------------o
T-TTT---XSSSSS--j------------------------------SSS
TT--T---X------------------------j----------------
T-TTT---X-----------------------j-j---------------
TTTTT--EX-E-EX---jMMMM--------Jj--?---------------
--------XS?S?X---QQ?QQ--------<>-----------------?
------------------------------[]------------jjj--J
------------------------------[]-----------------J
----------------------MMMMMMMJ[]---MMMMMMMMj---jMA
XXXXXXXXXXXXXXXXXXXXXXXXXXXXXXXXXXXXXXXXXXXX---XXX

使用的PROMPT: "some pipes, little enemies, many blocks, many coins,  no rect, high elevation"