--------------------------------------------------
--------------------------------------------------
-----jj-------------------------------------------
MMMMj--j------jj----------------------------------
TTTTT---jMMMMj-----------------------------------o
T--TT---XSSSSS--j------------------------------SSS
TTT-T---X------------------------j----------------
T--TT---X-----------------------j-j---------------
TTTTT--EX--E-X---jMMMM--------Jj--?---------------
--------XSS?SX---QQ?QQ--------<>-----------------S
------------------------------[]------------jjj--J
------------------------------[]-----------------J
----------------------MMMMMMMJ[]---MMMMMMMMj---jMA
XXXXXXXXXXXXXXXXXXXXXXXXXXXXXXXXXXXXXXXXXXXX---XXX

使用的PROMPT: "little pipes, some enemies, no blocks, no coins,  some rect, high elevation"