--------------------------------------------------
--------------------------------------------------
-----jj-------------------------------------------
MMMMj--j------jj----------------------------------
TTTTT---jMMMMj-----------------------------------o
TT-TT---XSSSSS--j-----------------------------SSSS
--T-T---X------------------------j--------------S-
TT-TT---X-----------------------j-j---------------
TTTTT--EX--E-X---jMMMM--------Jj--?---------------
-------XXSS?SX---QQ?QQ--------<>-----------------?
------------------------------[]------------jjj--J
------------------------------[]-----------------J
----------------------MMMMMMMJ[]---MMMMMMMMj---jMA
XXXXXXXXXXXXXXXXXXXXXXXXXXXXXXXXXXXXXXXXXXXX---XXX

使用的PROMPT: "no pipes, some enemies, many blocks, some coins,  little rect, low elevation"