--------------------------------------------------
--------------------------------------------------
-----jj-------------------------------------------
MMMMj--j------jj----------------------------------
TTTTT---jMMMMj-----------------------------------o
TT-TT---XSSSSS--j------------------------------SSS
--T-T---X------------------------j----------------
TT-TT---X-----------------------j-j---------------
TTTTT--EX--E-X---jMMMM--------Jj--?---------------
--------XSS?SX---QQ?QQ--------<>-----------------?
------------------------------[]------------jjj--J
------------------------------[]-----------------J
----------------------MMMMMMMJ[]---MMMMMMMMj---jMA
XXXXXXXXXXXXXXXXXXXXXXXXXXXXXXXXXXXXXXXXXXXX---XXX

使用的PROMPT: "no pipes, no enemies, many blocks, little coins,  some rect, high elevation"