--------------------------------------------------
--------------------------------------------------
-----jj-------------------------------------------
MMMMj--j------jj----------------------------------
TTTTT---jMMMMj-----------------------------------o
T--TT---XSSSSS--j------------------------------SSS
TTT-T---X------------------------j--------------S-
T--TT---X-----------------------j-j---------------
TTTTT--EX--E-X---jMMMM--------Jj--?---------------
--------XSS?SX---Q??QQ--------<>-----------------S
------------------------------[]------------jjj--J
------------------------------[]-----------------J
----------------------MMMMMMMJ[]---MMMMMMMMj---jMA
XXXXXXXXXXXXXXXXXXXXXXXXXXXXXXXXXXXXXXXXXXXX---XXX

使用的PROMPT: "some pipes, no enemies, some blocks, no coins,  many rect, low elevation"